)bR	ombres
)d	ondes
)dyle	ondulés
)gRwa	hongrois
)gl	ongles
)kl	oncles
)s	onces
)t	hontes
)z	onze
1bl	humbles
1tEl	untel
2Rop	euros
2dEm	oedèmes
2tanazi	euthanasies
5ZEkte	injectés
5Zeny	ingénus
5ZyR	injures
5besil	imbéciles
5bibe	imbibés
5d8iR	induire
5dEks	index
5dEmn	indemnes
5desi	indécis
5diNe	indignés
5diZEn	indigènes
5dis	indices
5dividy	individus
5dylZ@	indulgents
5dystRi	industries
5f@t(Ri	infanteries
5fEste	infestés
5fORmatik	informatiques
5faRktys	infarctus
5fami	infamies
5feRj9R	inférieurs
5fim	infimes
5fliZe	infligés
5flye	influé
5gRedj@	ingrédients
5k)be	incomber
5kRyste	incrustés
5kaRne	incarnés
5kaRseRe	incarcérés
5kjetyd	inquiétudes
5kline	inclinés
5klyR	inclure
5koNito	incognitos
5kylke	inculqués
5kylpe	inculpés
5pORte	importés
5pORtyne	importunés
5pOst9R	imposteurs
5pReNe	imprégnés
5pResaRjo	imprésarios
5pRovize	improvisés
5peRatif	impératifs
5plike	impliqués
5ploRe	implorée
5pyd@	impudents
5s@di	incendies
5sEst	incestes
5sOl@	insolent
5sOmni	insomnies
5sid@	incidents
5sin8e	insinuée
5sineRe	incinérés
5siste	insisté
5size	incisés
5skRiR	inscrire
5solit	insolites
5spEkte	inspectés
5spiRe	inspirés
5st5	instincts
5stR8iR	instruire
5stale	installés
5stity	instituts
5stoRe	instaurés
5sylin	insuline
5sylt	insultes
5t@s	intenses
5t@te	intentés
5tER)pR	interrompre
5tERdiR	interdirent
5tERfeRe	interféré
5tERna	internats
5tERoZe	interrogés
5tERpEle	interpellez
5tERpREt	interprètes
5tERpoze	interposés
5tERsEpte	interceptés
5tERv(niR	intervenir
5tERval	intervalles
5tEgR	intègres
5tEst5	intestins
5tRepid	intrépides
5tRig	intrigues
5tRy	intrus
5teRE	intérêts
5teRim	intérims
5teRj9R	intérieurs
5tegRe	intégrés
5teliZ@	intelligents
5v@te	inventés
5vEstiR	investirent
5vazj)	invasions
5vite	invités
5voke	invoqués
8e	hués
8i	huis
8il	huiles
8isje	huissiers
8itR	huîtres
9R	heurts
9f	oeuf
9j	oeils
9jE	oeillets
9vR	oeuvres
@S	hanches
@S@te	enchantés
@SER	enchères
@Sene	enchaînés
@Swa	anchois
@Z	anges
@Z2	enjeux
@Z5	engins
@Z@dRe	engendrés
@Zin	angines
@Zole	enjôlée
@Zwe	enjoués
@bEte	embêtés
@bRas	embrasses
@baRa	embarras
@baRase	embarrassés
@baRkadER	embarcadères
@bale	emballés
@basad	ambassades
@bete	embêter
@bigy	ambiguës
@bj@s	ambiances
@blEm	emblèmes
@boS	embauches
@bome	embaumés
@butiR	emboutir
@byl@s	ambulances
@byskad	embuscades
@d8iR	enduire
@dORfin	endorphines
@dRwa	endroits
@da	anda
@dikap	handicaps
@duj	andouilles
@f5	enfin
@fER	enfers
@fR5dR	enfreindre
@fetamin	amphétamines
@file	enfilés
@fle	enflés
@fwaRe	enfoirés
@fwiR	enfouir
@gaR	hangars
@gaZe	engagés
@gij	anguilles
@gl	angles
@glutiR	engloutirent
@guRdiR	engourdir
@gwas	angoisses
@k)bRe	encombrés
@kEt	enquêtes
@kOR	encore
@kR	encres
@ket	enquêté
@kl5	enclins
@kl@Se	enclenchés
@klo	enclos
@kode	encodés
@ksjete	anxiétés
@l(ve	enlevés
@n8i	ennuis
@nivRe	enivrés
@pR1	emprunts
@pR5t	empreintes
@paRe	emparés
@paje	empaillés
@pale	empalés
@peSe	empêchés
@piR	empires
@pifRe	empiffrées
@pjete	empiété
@pl	amples
@plwa	emplois
@pul	ampoules
@pyte	amputés
@s(v(liR	ensevelir
@s5t	enceintes
@s@	encens
@s@bl	ensembles
@sEN	enseignes
@sEtR	ancêtres
@seNe	enseignés
@siklopedi	encyclopédies
@sj5	anciens
@t	hantes
@t@dR	entendre
@tEn	antennes
@tORs	entorses
@tR	entres
@tR(pRiz	entreprises
@tR(po	entrepôts
@tR(t(niR	entretenir
@tR5	entrain
@tRaj	entrailles
@tRaks	anthrax
@tRakt	entractes
@tRave	entravés
@tRene	entraînés
@taj	entailles
@tame	entamés
@teRj9R	antérieurs
@tekRist	antéchrists
@tesed@	antécédents
@tiSe	entichés
@tik	antiquaires
@tipOd	antipodes
@tisipe	anticipés
@tite	entités
@tone	entonné
@tuRe	entourés
@tuzjasm	enthousiasmes
@tybe	entubés
@v(lOp	enveloppes
@vER	envers
@vERgyR	envergure
@vOl	envols
@vaiR	envahirent
@vi	envies
@viR)	environs
@vizaZe	envisagés
@vje	enviés
@vute	envoûtés
@vwaje	envoyés
@zim	enzymes
ER	ères
ER9R	erreurs
EREl	airelles
ERb	herbes
ERbag	airbag
ERmit	ermites
ERni	hernies
ERone	erronés
EbdomadER	hebdomadaires
Ed	aides
Egl	aigles
Egz@pl	exemples
Egz@te	exemptés
EgzERse	exercés
EgzERsis	exercices
EgzORsize	exorcisés
EgzaZeRe	exagérés
Egzakt	exacts
Egzalte	exaltés
Egzam5	examens
EgzaspeRe	exaspérés
Egzekyte	exécutés
EgziZe	exigés
Egzibe	exhibés
Egzil	exils
Egziste	existés
Egzose	exhaussée
Egzyme	exhumés
Ejs	ace
EksE	excès
EksEl@s	excellence
EksEpte	exceptés
Eksele	exceller
Eksite	excités
Ekski	exquis
EksklyR	exclure
EkskyRsj)	excursions
Ekskyz	excuses
EkspER	experts
EkspRE	exprès
EkspRime	exprimés
EkspeRj@s	expériences
Ekspedje	expédiés
EkspiRe	expirés
Ekspje	expiés
Eksplike	expliqués
EksploRe	explorés
Eksploze	explosés
Eksplwa	exploits
Ekspoze	exposés
Ekspylse	expulsés
EkstERn	externes
EkstORke	extorqués
EkstRE	extraits
EkstREm	extrêmes
EkstRa	extras
Ekstaz	extases
EksteRj9R	extérieurs
EkstiRpe	extirpés
EktaR	hectares
El(ve	élevés
Elf	elfes
Em(Rod	émeraudes
En(mi	ennemis
EsEl	aisselles
Esk5te	esquintés
EskORt	escortes
EskRim	escrimes
EskRo	escrocs
EskaRgo	escargots
EskadR	escadres
EskadR)	escadrons
Eskal	escales
EskalOp	escalopes
Eskalad	escalades
Eskapad	escapades
Eskimo	esquimaux
Eskis	esquisses
Eskiv	esquives
Esklav	esclaves
Eskwad	escouades
Eskydo	escudos
EspEs	espèces
EspRi	esprits
Espas	espaces
EspeRe	espérés
Espj)	espions
Espjone	espionnés
EspwaR	espoirs
Est)pe	estompés
EstRad	estrades
EstRopje	estropiés
Estetik	esthétiques
Estim	estimes
Estoma	estomacs
EtR	êtres
Etnik	ethniques
Ez	aises
Ez@s	aisances
N)	gnons
NOki	gnocchis
Nol	gnôle
ON)	oignons
OR	ort
ORZ	orges
ORbit	orbites
ORd	hordes
ORdR	ordres
ORdinER	ordinaires
ORdinat9R	ordinateurs
ORdone	ordonnés
ORdyR	ordures
ORf(l5	orphelins
ORf(lina	orphelinats
ORg	orgues
ORg9j	orgueils
ORgan	organes
ORgasm	orgasmes
ORk	orques
ORkEstR	orchestres
ORkide	orchidées
ORlOZ	horloges
ORmOn	hormones
ORmi	hormis
ORne	ornés
ORtEj	orteils
ORti	orties
ORtodOks	orthodoxes
ObZE	objets
Obi	hobby
Of	off
OfR	offres
OgR	ogres
OkE	hockey
OksiZEn	oxygènent
Oksid	oxydes
OktObR	octobre
OktRwaje	octroyés
Oktav	octaves
Om	hommes
OpsEk	obsèques
OpsEn	obscènes
OpskyR	obscurs
OpskyRsiR	obscurcir
OpsolEt	obsolètes
OpstRye	obstrués
Opstakl	obstacles
Opstine	obstinés
Opt(niR	obtenir
Opt@peRe	obtempéré
Opte	opté
Opty	obtus
Os	os
OskaR	oscars
Ospis	hospices
Ospitalite	hospitalité
Ospitalize	hospitalisés
Ostil	hostiles
Osto	hostos
Ot	hottes
Ov9Rdoz	overdoses
Ovni	ovnis
R(ZistR	registres
R(Zt)	rejetons
R(bRuse	rebroussés
R(flE	reflets
R(fyZ	refuges
R(gRE	regrets
R(k5	requins
R(k5ke	requinqués
R(k9j	recueils
R(kRyte	recrutés
R(keRiR	requérir
R(kuvRe	recouvrés
R(kyl	reculs
R(lEv	relèves
R(laks	relaxes
R(late	relatés
R(leje	relayés
R(liZj)	religions
R(lik	reliques
R(ljEf	reliefs
R(lyke	reluqués
R(mEd	remèdes
R(mORk	remorques
R(n)se	renoncée
R(naR	renards
R(nega	renégats
R(nifle	reniflées
R(p@tiR	repentirs
R(pORtaZ	reportages
R(pRoS	reprochés
R(peRaZ	repérages
R(peRe	repérés
R(poRtER	reporter
R(s(le	recelés
R(s(vwaR	recevoir
R(sase	ressassés
R(sikle	recyclés
R(t@tiR	retentirent
R(v@S	revanches
R(v@dike	revendiquée
R(vj5	revient
R)	ronds
R)Ze	rongés
R)fle	ronflé
R)pR	rompre
R5	reins
R5gaR	ringards
R5se	rincés
R8El	ruelles
R8in	ruines
R8iso	ruisseaux
R9S	rushes
R@	rends
R@buRse	remboursés
R@dR	rendre
R@done	randonnées
R@dy	rendus
R@fOR	renforts
R@k)tR	rencontres
R@k9R	rancoeurs
R@kaR	rencards
R@kaRde	rencardés
R@kyn	rancunes
R@nS	ranches
R@p	rampes
R@paR	remparts
R@pli	remplît
R@s)	rançons
RE	rets
REN	règnes
REg	reg
REks	rex
REktifje	rectifiés
REptil	reptiles
REskape	rescapés
REskus	rescousse
REspE	respects
REspEktif	respectifs
REspiRe	respirés
REst	restes
REstR5dR	restreindre
REstit8e	restitués
REstoRe	restaurés
REv	rêves
REz)	raisons
REz5	raisins
RON	rognes
ROS	roches
ROb	robes
ROk	roques
ROl	rolle
ROl9R	rollers
ROsbif	rosbifs
Ra	raz
Rab	rabs
Rab5	rabbins
RabaSe	rabâchées
Rad	rads
Rad5	radins
RadaR	radars
Radi	radis
Radjat9R	radiateurs
Radjo	radios
Radote	radoté
Rafal	rafales
Rafine	raffinés
Rafjo	rafiots
Rafl	rafles
Rago	ragots
Ragu	ragoûts
Rajd9R	raiders
Rak)te	racontés
RakEt	raquettes
Rakaj	racailles
Rakle	raclés
RaklyR	raclures
Rali	rallyes
Ram	rams
Ramad@	ramadan
Ramasi	ramassis
Ramo	rameaux
Rap	râpes
RapatRije	rapatriés
Rapid	rapides
Rasazje	rassasiés
Rasin	racines
Rasjal	raciales
Rat)	ratons
Ratise	ratissés
Rav	raves
Rav5	ravins
RavaZ	ravages
RaviR	ravirent
Ravitaje	ravitaillés
Ravive	ravivée
Ravjoli	raviolis
Raze	rasés
RazwaR	rasoirs
Re	ré
ReZiR	régir
ReZj)	régions
Realize	réalisés
Rebelj)	rébellions
Red8iR	réduire
RediZe	rédigés
RefEktwaR	réfectoires
RefeRe	référés
ReflEks	réflexes
RefleSi	réfléchît
RefyZje	réfugiés
Refyte	réfutées
Regat	régates
Rege	reggaes
Regle	réglés
RejyR	rayures
Rek)p@s	récompenses
Rek)silje	réconciliés
Rek8ijEm	requiems
RekOlt	récoltes
RekRe	récrés
Rekizisjone	réquisitionnés
Reklam	réclames
RekyR@	récurrents
RekypeRe	récupérés
RemyneRe	rémunérés
Renove	rénovés
Rep)s	réponses
RepERtwaR	répertoires
RepRim@d	réprimand
Repete	répétés
Replik	répliques
RepyNe	répugnée
Repyblik5	républicains
Repydje	répudiés
Repyte	réputés
Resif	récifs
ResipROk	réciproques
Resipj@	récipients
Resital	récitals
RetRakte	rétractés
RetResiR	rétrécirent
Retis@	réticents
RevEj)	réveillons
RevOlt	révoltes
RevOlvER	revolvers
Reve	rêvés
ReveR@	révérends
Revele	révélés
Revoly	révolus
Reysit	réussites
RezERv	réserves
RezERvwaR	réservoirs
ReziNe	résignés
Rezid@	résidents
Rezide	résidé
Rezidy	résidus
Reziste	résisté
Rezo	réseaux
Rezoly	résolut
Rezone	résonné
RezudR	résoudre
Rezylta	résultats
Rezyme	résumés
RiG	rings
RiR	rires
RiS	riches
RiZid	rigides
Rid	rides
Ridikyl	ridicules
Rido	rideaux
Rig9R	rigueurs
RigOl	rigoles
Rigole	rigolé
Rikane	ricané
Rim	rîmes
RinoseROs	rhinocéros
RipOst	ripostes
Ripu	ripoux
Risk	risques
Rit8El	rituels
Ritm	rythmes
Riv	rives
Rival	rivales
RivjER	rivières
Rize	risées
Rj5	riens
Ro	rôts
RoN)	rognons
RobER	roberts
RobinE	robinets
Robo	robots
Robyst	robustes
Rode	rôdés
Rodeo	rodéos
Rok9R	rockeurs
Rom@	romans
RomaR5	romarin
RosiNOl	rossignols
RotiR	rôtir
Rotyl	rotules
RozER	rosaires
RoziR	rosir
Rozo	roseaux
Ru	roux
RuZ	rouges
Rubl	roubles
Ruj	rouilles
Ruk5	rouquins
Rul	roules
RulOt	roulottes
Rulo	rouleaux
Rund	rounds
Rupije	roupillé
Rus9R	rousseurs
Rusi	roussit
Ruspete	rouspétez
Rutin	routines
Rutje	routiers
Rwajal	royales
Rwajom	royaumes
Rwe	roués
Ry	rus
RyRal	rurales
RyS	ruches
RyZiR	rugirent
Ryb@	rubans
RybRik	rubriques
Rybi	rubis
Ryd	rudes
Rygbi	rugby
Rym	rhumes
Rymine	ruminés
RyptyR	ruptures
RystR	rustres
Rystik	rustiques
S(m5	chemins
S(mine	cheminées
S(mino	cheminots
S(miz	chemises
S(nap@	chenapans
S(nij	chenilles
S(nil	chenils
S(v2	cheveux
S(vE	chevets
S(vR)	chevrons
S(vR9j	chevreuils
S(val	cheval
S(vij	chevilles
S(voSe	chevauchés
S5p@ze	chimpanzés
S@	chants
S@Z	changes
S@bR	chambres
S@bule	chamboulés
S@dEl	chandelles
S@paN	champagnes
S@pj)	champions
S@pw5	shampooings
S@s(le	chancelé
S@s)	chansons
S@taZ	chantages
S@tje	chantiez
SER	chères
SERSe	cherchés
SERif	sheriff
SEf	chefs
SEk	scheik
SEn	chênes
SEvR	chèvres
SEz	chaises
SORt	shorts
SOk	choquent
SOpe	chopper
SOpiG	shoppings
Sa	shahs
SaR	chars
SaRON	charognes
SaRZ	charges
SaRabja	charabias
SaRb)	charbons
SaRite	charités
SaRjo	chariots
SaRkyte	charcutés
SaRlat@	charlatans
SaRm	charmes
SaRt	chartes
SaRy	charrues
Saba	shabbat
SagR5	chagrins
Sakal	chacals
Sal	shale
Sal9R	chaleurs
SalE	chalets
Salymo	chalumeaux
Salytje	chalutiers
Saman	shamans
Samo	chameaux
Sap(R)	chaperons
Sap)	chapons
SapEl	chapelles
SapitR	chapitres
Sapito	chapiteaux
Sapo	chapeaux
Sase	chassés
Sast	chastes
SatEN	châtaignes
Satje	châtiez
Sato	châteaux
Satuje	chatouillés
SaviRe	chavirés
Say	chahuts
Se	chez
SeRiR	chérir
SeRif	shérifs
SeRyb5	chérubins
Sekje	chéquiers
Sema	schémas
SiN)	chignons
SiRyRZi	chirurgies
SiS	chiches
SiSi	chichis
Sif)	chiffons
SifR	chiffres
Sik	chiques
Sili	chili
SiliG	shillings
SimER	chimères
Sinwa	chinois
Sip	chipe
Sit	shit
Sj5	chiens
Sje	chiés
So	shows
SoSOt	chochottes
SodR)	chaudrons
SodjER	chaudières
SofaR	chauffards
Sofe	chauffés
Soke	choqués
Sokola	chocolats
Some	chômés
SomjER	chaumières
Sope	chopés
Sos)	chaussons
SosyR	chaussures
Sov	chauves
Su	choux
SuSu	chouchous
SukRut	choucroutes
Sut	shoots
SwEt	chouettes
Swa	choix
SwaR	choir
SwaziR	choisirent
SySote	chuchotés
Syt	chutes
Z(le	gelés
Z(nu	genoux
Z(t)	jetons
Z(te	jetés
Z)gle	jonglé
Z1gl	jungles
Z2	jeux
Z2di	jeudis
Z2n	jeûnes
Z5Z@bR	gingembre
Z5dR	geindre
Z85	juin
Z8if	juifs
Z8ijE	juillets
Z9n	jeunes
Z9nki	junkies
Z9no	jeunots
Z@	jans
Z@R	genres
Z@b	jambes
Z@b)	jambons
Z@dR	gendres
Z@daRm	gendarmes
Z@siv	gencives
Z@t	jantes
Z@ti	gentils
Z@vje	janvier
ZERb	gerbes
ZERm	germes
ZERm5	germains
ZEl	gèles
ZEn	gênes
ZEst	gestes
ZaR	jars
ZaRE	jarrets
ZaRd5	jardins
ZaRg)	jargons
Zadis	jadis
ZajiR	jaillirent
Zak	jacques
Zakase	jacassé
Zakpo	jackpot
Zakyzi	jacuzzis
Zalu	jaloux
ZamE	jamais
Zap	japs
Zasm5	jasmins
ZavEl	javelles
Zaze	jasé
ZeRanjOm	géraniums
ZeRe	gérés
ZemiR	gémirent
Zene	gênés
ZeneRe	générés
Zeni	jenny
Zez8it	jésuites
ZeziR	gésir
Zezy	jésus
ZiRaf	girafes
ZibE	gibets
Zibje	gibiers
Zifl	gifles
Zigo	gigots
Zigolo	gigolos
Zikle	giclées
ZilE	gilets
Zim	gym
Zit	gîtes
Zit)	gitons
Zit@	gitans
ZivRe	givrés
ZoZ	jauges
ZoZo	jojos
ZokE	jockeys
ZokER	jokers
Zoli	jolis
Zon	jaunes
Zu	jougs
ZuR	jours
ZuRnal	journal
ZuRne	journées
ZuZu	joujoux
Zut	joutes
Zw5	joints
Zwa	jouât
Zwajo	joyaux
Zwe	joués
ZwiR	jouirent
Zy	jus
ZyR)	jurons
ZyRe	jurés
ZyRi	jurys
ZyZ	juges
ZyZOt	jugeote
Zybile	jubilée
Zyda	judas
ZydisjER	judiciaires
Zyl	jules
ZymEl	jumelles
Zymo	jumeaux
ZynjOR	juniors
Zyp	jupes
Zysk	jusques
Zyst	justes
Zystis	justices
Zyvenil	juvéniles
aNo	agneaux
aORt	aorte
aR	harts
aR@	harengs
aR@Ze	arrangés
aRE	haret
aRENe	araignées
aREm	harems
aREn	arènes
aREt	arêtes
aRS	arches
aRS(vEk	archevêques
aRSitEkt	architectes
aRSiv	archives
aRZ@	argents
aRZil	argiles
aRaSe	arrachés
aRab	arabes
aRbR	arbres
aRbitR	arbitres
aRbitRER	arbitraires
aRbyst	arbustes
aRd	hardes
aRd9R	ardeurs
aRd@	ardents
aRdi	hardis
aRdwaz	ardoises
aRdy	ardus
aRete	arrêtés
aRgo	argots
aRid	arides
aRiko	haricots
aRive	arrivés
aRj5	aryens
aRjER	arrières
aRk	arquent
aRk@Z	archanges
aRkad	arcades
aRkaik	archaïques
aRkeoloZi	archéologie
aRm	armes
aRmada	armadas
aRmistis	armistices
aRmoni	harmonies
aRmonika	harmonicas
aRmwaR	armoires
aRmyR	armures
aRnE	harnais
aRnak	arnaques
aRog@s	arrogance
aRom	arômes
aRoze	arrosés
aRp	harpes
aRp)	harpons
aRp@te	arpentés
aRs(le	harcelés
aRs2nal	arsenal
aRs2nik	arsenic
aRtER	artères
aRtiSo	artichauts
aRtifis	artifices
aRtij(Ri	artillerie
aRtikl	articles
aRtikyle	articulés
aRtiz@	artisans
aS	hasch
aS(te	achetés
aS(ve	achevés
aSa	hacha
aSaRne	acharnés
aSi	hachis
aZ	âges
aZ5da	agendas
aZ@	agents
aZiR	agirent
aZil	agiles
aZite	agités
ab)de	abondé
ab@d)	abandons
abEj	abeilles
abOR	abords
abR9ve	abreuvés
abReZe	abrégés
abRi	abris
abRiko	abricots
abRypt	abrupts
abRytiR	abrutir
abZEkt	abjects
abZyRe	abjuré
abatR	abattre
abdomEn	abdomen
abe	aber
abei	abbayes
abese	abc
abi	habits
abim	abîmes
abita	habitât
abityd	habitudes
aboliR	abolir
abone	abonnés
abu	about
abule	aboulez
abutiR	aboutirent
abwaje	aboyé
aby	abus
abyze	abusés
adEpt	adeptes
adOpte	adoptés
adREs	adresses
adRenalin	adrénalines
adRese	adressés
adRwa	adroits
adZ	hadj
adZw5	adjoints
adZyZe	adjugés
adapte	adaptés
adeRe	adhéré
adekwa	adéquats
adj2	adieux
admEtR	admettre
admiRe	admirés
administRe	administrés
ado	ados
adoRe	adorés
adoles@	adolescents
adone	adonnés
adv(niR	advenir
advERs	adverses
advERsER	adversaires
adylt	adultes
aeRe	aérés
aeRobik	aérobics
aeRodRom	aérodromes
afER	affaires
afEkte	affectés
afR)te	affrontés
afR@SiR	affranchir
afRik5	africains
afRo	afro
afRodizjak	aphrodisiaques
afale	affalés
afese	affaissés
afg@	afghans
afiRme	affirmés
afiS	affiches
afile	affilés
afliZe	affligés
aflye	afflué
afole	affolés
afy	affûts
agRaf	agrafés
agRee	agréés
agRese	agressés
agRikyltyR	agriculture
agRipe	agrippés
agase	agacés
agonize	agonisé
aiR	haïr
aj	aïe
aj)	haillons
aj9R	ailleurs
aj9l	aïeuls
ajsbERg	icebergs
ak)pliR	accomplirent
ak)t	acomptes
ak9j	accueils
akORde	accordés
akORde)	accordéons
akOste	accostées
akRoSe	accrochés
akRobat	acrobates
akRupiR	accroupirent
akable	accablés
akademi	académies
akeRiR	acquérir
aki	acquits
akjese	acquiescer
akne	acnés
akolit	acolytes
aks	axes
aks@	accents
aksE	accès
aksEpte	acceptés
aksede	accédé
akseleRe	accélérés
akseswaR	accessoires
aksid@	accidents
aksis	axis
aksjonER	actionnaires
akt	actes
akt8El	actuels
akt9R	acteurs
aktive	activés
akuRiR	accourir
akwaRjOm	aquariums
akyle	acculés
akyze	accusés
al	hâles
al)Ze	allongés
al@tuR	alentours
alERZi	allergies
alERt	alertes
alEn	haleines
alOR	alors
alSimi	alchimies
alZEbR	algèbre
alaRm	alarmes
albOm	albums
albatRos	albatros
aleatwaR	aléatoires
alfabE	alphabets
alg	algues
aliNe	alignés
alibi	alibis
aligatOR	alligators
aljas	alias
alkOl	alcools
alkatRaz	alcatraz
alkolo	alcoolos
almanak	almanachs
alo	halos
alp5	alpins
alt	haltes
altERnativ	alternatives
altERne	alternés
alteRe	altérés
altityd	altitudes
alwEt	alouettes
aly	alu
alyR	allures
alyme	allumés
alyminjOm	aluminium
alysine	hallucinés
alyzj)	allusions
am(ne	amenés
am(s)	hameçons
am)	amont
am2te	ameutés
am@d	amendes
amER	amères
amERlOk	amerloques
amERtym	amertumes
amEn	amènes
amORs	amorces
amORtiR	amortirent
ama	amas
amaR	amarres
amaRo	amaro
amadwe	amadoué
amak	hamacs
amase	amassés
ameljoRe	améliorés
amenaZe	aménagés
ami	amis
amiRal	amirale
amidal	amygdales
amnisti	amnisties
amoSe	amochés
amstER	hamsters
amuR	amours
amyze	amusés
an	ânes
an)s	annonces
an8ER	annuaires
anEkdOt	anecdotes
anEks	annexes
anEstezi	anesthésies
anORmal	anormales
ana	anas
anaRSi	anarchie
analist	analystes
analiz	analyses
anana	ananas
anatEm	anathèmes
anatomi	anatomies
ane@tiR	anéantirent
anemi	anémie
animal	animales
anis	anis
anivERsER	anniversaires
ano	anneaux
anod5	anodins
anomali	anomalies
anonim	anonymes
anyle	annulés
anys	anus
ap(le	appelés
ap5dis	appendices
ap8i	appuis
apERsy	aperçût
apEl	appels
apORte	apportés
apR	âpres
apR@dR	apprendre
apR@ti	apprentis
apRE	après
apRe@de	appréhendés
apResje	appréciés
apRete	apprêtés
apRivwaze	apprivoisés
apRoSe	approchés
apRuve	approuvés
apa	happa
apaREj	appareils
apaReje	appareiller
apaRt	appart
apaRt(niR	appartenir
apeRitif	apéritifs
apeti	appétits
apeze	apaisés
apitwaje	apitoyés
apl)	aplombs
aplike	appliqués
aplodiR	applaudirent
apoZe	apogée
apokalips	apocalypses
apotR	apôtres
aps5t	absinthe
aps@	absents
apsE	abcès
apsORbe	absorbés
apsoly	absolus
apst(niR	abstenir
apstRE	abstraits
apsudR	absoudre
apsyRd	absurdes
apt	aptes
aptityd	aptitudes
as	asse
as)bRiR	assombrirent
as@ble	assemblés
as@sj)	ascensions
asERviR	asservir
asORtiR	assortir
asajiR	assaillirent
asas5	assassins
aseSe	asséchés
asfalt	asphalte
asfiksi	asphyxient
asi	assît
asiNe	assignés
asid	acides
asimile	assimilés
asiste	assistés
asjEt	assiettes
asjeRi	aciéries
asjeZe	assiégés
asm	asthmes
aso	asseau
asome	assommés
asosje	associés
aspE	aspects
aspERZ	asperges
aspiRe	aspirés
aspiRin	aspirines
astR	astres
astike	astiqués
astiko	asticots
astys	astuces
asupiR	assoupir
asuviR	assouvirent
aswaR	asseoir
asyme	assumés
at	hâtes
at(le	attelés
at(lje	ateliers
at5	atteints
at5dR	atteindre
at@dR	attendre
at@dRiR	attendrirent
at@ta	attentats
atRE	attraits
atROs	atroces
atRap	attrapes
atRiby	attributs
ataS	attaches
atak	attaques
ateRiR	atterrir
aten8e	atténués
atiRaj	attirail
atiRe	attirés
atityd	attitudes
atlEt	athlètes
atom	atomes
atu	atouts
av(niR	avenirs
av(ny	avenus
av2	aveux
av9gl	aveugles
av@se	avancés
av@taZ	avantages
av@tyR	aventures
avERs	averses
avERtiR	avertirent
avEk	avec
avORt)	avortons
avORte	avortés
avRil	avril
avaR	avares
avaRi	avaries
aval	avales
aval@S	avalanches
avataR	avatars
ave	haver
aveRe	avérés
avi	avis
aviR)	avirons
avid	avides
avize	avisés
avj)	avions
avoka	avocats
avwaR	avoirs
avwan	avoines
avwe	avoués
awt	out
awz	house
azOt	azote
azaR	hasards
azil	asiles
azyR	azurs
b(lEt	belettes
b(nE	benêts
b)	bons
b)ZuR	bonjours
b)b	bombes
b)b)	bonbons
b)de	bondés
b)swaR	bonsoirs
b2	boeufs
b2zON	besognes
b2zw5	besoins
b5	ben
b8is)	buissons
b9R	boer
b9f	boeuf
b9g	bug
b@	bans
b@b5	bambins
b@bu	bambous
b@d	bandes
b@dZo	banjos
b@di	bandits
b@do	bandeaux
b@g	bangs
b@k	banques
b@kE	banquets
b@kEt	banquettes
b@lj2	banlieues
bE	bey
bENE	beignets
bERZ	berges
bERkaj	bercail
bERlin	berlines
bERne	bernés
bERse	bercés
bERso	berceaux
bEZ	beiges
bEk	becs
bEl	bêlent
bElZ	belges
bEn	bennes
bEt	bêtes
bEt(Rav	betteraves
bEta	bêtas
bOR	bore
bORN	borgnes
bORdEl	bordels
bORn	bornes
bOdi	body
bOks	boxes
bOl	bols
bOs	bosses
bOt	bottes
bR(bi	brebis
bR(duj	bredouilles
bR(tEl	bretelles
bR)Se	bronché
bR)z	bronzes
bR1	bruns
bR2l@	brelans
bR2vE	brevets
bR5	brins
bR5dij	brindilles
bR5g	bringue
bR8i	bruits
bR9nS	brunchs
bR@S	branches
bR@diR	brandirent
bR@kaR	brancards
bR@le	branlés
bRES	brèches
bREdzEl	bretzels
bREf	brefs
bREk	breaks
bREz	braises
bROS	broches
bROs	brosses
bRa	bras
bRagEt	braguettes
bRake	braqués
bRas(Ri	brasseries
bRas(lE	bracelets
bRase	brassés
bRavo	bravos
bRavuR	bravoure
bRazje	brasiers
bRid	brides
bRife	briffer
bRig@	briguant
bRigad	brigades
bRijOS	brioches
bRije	brillé
bRik	briques
bRikE	briquets
bRikole	bricolés
bRitiS	british
bRiz	brize
bRoSyR	brochures
bRode	brodés
bRokoli	brocolis
bRose	brossés
bRuEt	brouettes
bRuaa	brouhahas
bRuj)	brouillons
bRujaR	brouillards
bRuje	brouillés
bRusaj	broussailles
bRute	broutés
bRutij	broutilles
bRwaje	broyés
bRy	brus
bRylyR	brûlures
bRym	brumes
bRysk	brusques
bRyt	bruts
ba	bâts
baN	bagnes
baNOl	bagnoles
baR	bars
baR)	barrons
baROk	baroques
baRZ	barjes
baRZo	barjots
baRak	baraques
baRakyda	barracuda
baRat5	baratins
baRb	barbes
baRb(kju	barbecues
baRb(le	barbelés
baRbaR	barbares
baRbuje	barbouillés
baRda	bardas
baRde	bardés
baRikad	barricades
baRil	barils
baRjER	barrières
baRk	barques
baRman	barmans
baRo	barreaux
baRtavEl	bartavelles
baS	bâches
babOR	bâbord
baba	babas
babjOl	babioles
babw5	babouins
badZ	badges
baf	baffes
bafuje	bafouillé
bafwe	bafoués
bag	bagues
bagEt	baguettes
bagaR	bagarres
bagaZ	baguage
bagatEl	bagatelles
baj	bâilles
bak	bacs
bakle	bâclés
bakteRi	bactéries
bal	bals
bal(Rin	ballerines
bal)	ballons
bal@s	balances
balE	ballets
balEn	baleines
balad	ballades
balast	ballasts
baleje	balayés
balivERn	balivernes
baliz	balises
balk)	balcons
balo	bat-l'eau
banal	banals
banan	bananes
banjER	bannières
bas5	bassins
basine	bassines
bask	basques
baskEt	baskets
baskyl	bascules
bast	baste
bast)	bastons
bastid	bastides
bastij	bastilles
bat	battes
bat)	bâtons
batEm	baptêmes
batR	battre
bataR	bâtards
bataj	batailles
batiR	bâtirent
batifole	batifolé
bato	bateaux
baty	battus
bav	baves
bavaR	bavards
bavaRde	bavardé
bavyR	bavures
bay	bahuts
bazaR	bazars
baze	basés
bazilik	basiliques
bazuka	bazookas
beNe	baignés
beRE	bérets
bebe	bébés
beg5	béguins
begeje	bégayées
bejbi	baby
bekan	bécanes
bekas	bécasses
bekij	béquilles
bekon	bacon
bekote	bécotés
belje	béliers
ben5	bénins
benefis	bénéfices
benevOl	bénévoles
beniR	bénir
bese	baissés
bet)	bétons
betEl	bétel
betaj	bétails
betiz	bêtises
bezbol	baseball
beze	baisés
biGo	bingo
biS	biches
biZu	bijoux
bib(R)	biberons
bib(lo	bibelots
bibl	bibles
biblijotek	bibliothécaires
bid	bides
bid)	bidons
bidyl	bidules
biftEk	biftèques
bigORno	bigorneaux
bij	billes
bijE	billets
bijaR	billards
bikini	bikinis
bikoz	bicause
bil	bills
bil@	bilans
bildiG	buildings
bip	bips
bisEps	biceps
bisk8i	biscuits
bistRo	bistrots
bit	bytes
bitym	bitumes
biz)	bisons
bizaR	bizarres
biznEs	business
bizu	bizou
bizy	bizuts
bj5	biens
bj5to	bientôt
bj5v(ny	bienvenus
bjE	biais
bjER	bières
bjEl	bielles
bjOpsi	biopsies
bjo	bio
bl)	blonds
bl2	bleus
bl2E	bleuets
bl5de	blindés
bl9f	bluffs
bl@	blancs
blERo	blaireaux
blEd	bleds
blEm	blêmes
blOk	bloques
blOkos	blockhaus
blag	blagues
blak	blacks
blam	blâmes
blasfEm	blasphèmes
blaze	blasés
ble	blés
bleRe	blairé
blese	blessés
blesyR	blessures
blizaR	blizzards
bloke	bloqués
blokys	blocus
blotiR	blottirent
bluz	blues
bluz)	blousons
bo	bot
boEm	bohême
boa	boas
bobaR	bobards
bobin	bobines
bobo	bobos
bodo	bodo
boemj5	bohémiens
bof	beaufs
bokal	bocal
boku	beaucoup
bom	bôme
bon9R	bonheurs
bonE	bonnets
boniR	bonnir
bonys	bonus
bose	bossé
bosy	bossus
bot5	bottins
botin	bottines
bu	bouts
buR	bourres
buRZ	bourges
buRZwa	bourgeois
buRb)	bourbons
buRbje	bourbiers
buRd	bourdes
buRd)	bourdons
buRgmEstR	bourgmestres
buRo	bourreaux
buS	bush
buS)	bouchons
buZ	bouges
buZi	bougies
bud5	boudins
bude	boudés
buf	bouffes
buf)	bouffons
bufi	bouffis
bugR	bougres
bujiR	bouillir
bujwaR	bouilloires
buk	boucs
buk5	bouquins
buk@	boucan
bukl	boucles
bul	boulle
bul(vERse	bouleversés
bul(vaR	boulevards
bul)	boulons
bul@Ze	boulangers
bulo	bulot
bum	boums
bum(R@g	boomerang
bum9R	boomer
bunkER	bunkers
busOl	boussoles
buskyle	bousculés
but)	boutons
butEj	bouteilles
butik	boutiques
bwa	boit
bwaR	boire
bwajaR	boyards
bwajo	boyaux
bwas)	boissons
bwat	boîtes
bwe	bouées
by	bût
byREt	burettes
byRn	burnes
byRo	bureaux
byS	bûches
bydZE	budgets
byfE	buffets
byfl	buffles
byl	bulls
byl(t5	bulletins
byldozER	bulldozers
byst	bustes
byt	buttes
byt5	butins
d(bu	debout
d(d@	dedans
d(gRe	degrés
d(la	delà
d(m5	demains
d(m9R	demeures
d(m@d	demandes
d(mi	demis
d(nje	deniers
d(p8i	depuis
d(su	dessous
d(sy	dessus
d(v(niR	devenir
d(v5	devînt
d(v@se	devancés
d(vine	devinés
d(viz	devises
d(vwaR	devoirs
d)	dont
d)Z)	donjons
d)k	donc
d)pte	domptés
d2	deux
d2OR	dehors
d5	daims
d5d	dindes
d5d)	dindons
d5g	dingues
d8El	duels
d8o	duos
d9j	deuils
d@	dents
d@Re	denrées
d@Ze	dangers
d@ble	d'emblée
d@di	dandys
d@se	dansée
d@tEl	dentelles
dE	dès
dER	ders
dERjER	derrières
dERnje	derniers
dElta	deltas
dEs(le	déceler
dEs(vwaR	décevoir
dEt	dettes
dEt(niR	détenir
dEt(ny	détenue
dORlote	dorlotés
dORmiR	dormirent
dOk	docks
dOkt9R	docteurs
dOktRin	doctrines
dOltSe	dolce
dOn	donnes
dOp	dopes
dOt	dots
dR5	drains
dR8id	druides
dR9gstOR	drugstores
dROp	droppe
dRa	draps
dRaZe	dragées
dRag	dragues
dRag)	draguons
dRaj	dry
dRajv	drive
dRakm	drachmes
dRam	drames
dRapo	drapeaux
dRese	dressés
dRoge	drogués
dRol	drôles
dRon	drones
dRwa	droits
dZ9mp9R	jumper
dZEt	jets
dZOb	jobs
dZOgiG	joggings
dZak	jack
dZaz	jazz
dZin	jean
dZing9l	jingle
dZip	jeeps
da	da
daR	dards
dabOR	d'abord
dada	dadas
dag	dagues
daja	daya
dal	dalles
dam	dames
dane	damnés
dat	dattes
datSa	datchas
dav@taZ	davantage
de	dés
de@byle	déambulé
deNe	daigné
deRaje	déraillé
deRizj)	dérision
deRizwaR	dérisoires
deRobe	dérobés
deSE	déchets
deSe@s	déchéances
deSiRe	déchirés
deSiRyR	déchirures
deSik(te	déchiquetés
deSy	déchus
deZ9ne	déjeuné
debRi	débris
debaRa	débarras
debaRke	débarqués
debale	déballés
debine	débinés
deboS	débauches
debuRse	déboursées
debyske	débusqués
ded8iR	déduire
dedikas	dédicaces
dedje	dédiés
def1	défunts
def@s	défenses
defERle	déferlées
defi	défit
defisit	déficits
deg2las	dégueulasses
degERpiR	déguerpirent
degR5gole	dégringolés
degene	dégainer
degize	déguisés
degl5ge	déglingués
degome	dégommés
degote	dégotés
deguRdiR	dégourdir
deguline	dégouliné
degyste	dégustés
dekRete	décrétés
dekRiR	décrire
dekRoSe	décrochés
dekapite	décapités
dekl@Se	déclenchés
deklaRe	déclarés
dekline	déclinée
dekoRe	décorés
dekolaZ	décollages
dekone	déconné
dekuRaZe	découragés
dekuvERt	découvertes
del5k@s	délinquances
deliRe	déliré
delika	délicats
dem@s	démence
dem@t(le	démantelés
dem@ti	démentit
demaRaZ	démarrages
demne	démener
den)se	dénoncés
denigRe	dénigrés
dep(se	dépecés
dep@d@s	dépendances
depORte	déportés
depRave	dépravés
depane	dépannés
deploRe	déplorés
deplwaje	déployés
depotwaR	dépotoir
depuRvy	dépourvus
depuj	dépouilles
depyte	députés
des@bR	décembres
des@t	décentes
desE	décès
deseni	décennies
deside	décidés
desime	décimés
dest5	destins
destRwaje	destroyers
destine	destinés
detERZ@	détergents
detEkte	détectés
detR8iR	détruire
detRitys	détritus
detRwa	détroits
detaje	détaillés
detale	détalé
deteRe	déterrés
deteRjoRe	détériorés
dev(lope	développés
dev)	devon
devERg)de	dévergondés
devaste	dévastés
devje	déviés
devoRe	dévorés
dez5vOlt	désinvoltes
dezORmE	désormais
dezaRwa	désarrois
deziNe	désignés
deziR	désirs
dezole	désolés
diN	dignes
diR	dires
diREkt	directs
diRiZe	dirigés
diZeRe	digérés
difORm	difformes
difeRe	différés
difisil	difficiles
difyze	diffusés
dig	digues
diksjonER	dictionnaires
dikt)	dictons
diktatyR	dictatures
dikte	dictés
dil	deals
dil8e	dilués
dil9R	dealers
dilapide	dilapidées
dilate	dilatés
diliZ@s	diligences
dim@sj)	dimensions
dimin8e	diminués
din	dînes
dinaR	dinars
dinamit	dynamite
dinasti	dynasties
dinozoR	dinosaures
diplom	diplômes
diplomat	diplomates
dis8ade	dissuadés
disERne	discernées
disZ)kte	disjonctée
diseke	disséqués
disimyle	dissimulés
disipe	dissipés
disipl	disciples
disiplin	disciplines
disk	disques
diskylpe	disculpés
diskyte	discutés
disp@sER	dispensèrent
dispaRy	disparût
disponibl	disponibles
dispyte	disputés
dist5ge	distingués
distRib8e	distribués
distRikt	districts
distile	distillés
disudR	dissoudre
divERtiR	divertirent
divORs	divorces
diva	divas
divage	divagué
divize	divisés
divizj)	divisions
divylge	divulgués
dizEn	dizaines
dizajn	designs
dj2	dieux
djaRe	diarrhées
djabEt	diabètes
djadEm	diadèmes
djafRagm	diaphragmes
djagnostik	diagnostiques
djalEkt	dialectes
djaliz	dialyses
djalog	dialoguées
djamEtR	diamètre
djapo	diapos
djetetik	diététiques
djezEl	diesels
do	dos
doRe	dorés
dobERman	dobermans
dodo	dodos
dof5	dauphins
dokym@	documentés
dolaR	dollars
dom	dômes
domEn	domaines
domEstik	domestiques
domaZ	dommages
domine	dominés
domino	dominos
domisil	domiciles
done	donnés
dopamin	dopamine
dope	dopés
dosil	dociles
dosje	dossiers
du	doux
duS	douches
dubl	doubles
dublyR	doublures
duj	douilles
dujE	douillets
dul9R	douleurs
dut	doutes
dutSe	duces
duzEn	douzaines
dwa	doit
dwaj5	doyens
dwan	douanes
dwe	doués
dy	dût
dyR	durs
dyRj@	durian
dyk	ducs
dyka	ducats
dyn	dunes
dyp	dupes
dyvE	duvets
e)te	éhontés
eRabl(	érable
eRadike	éradiquée
eRaflyR	éraflures
eRezi	hérésies
eRiZe	érigés
eRite	hérités
eRo	héros
eRotism	érotiques
eRydi	érudits
eSEk	échecs
eSEl	échelles
eSaRp	écharpes
eSalOt	échalotes
eSape	échappés
eSe@s	échéances
eSin	échines
eSwe	échoués
eZEkte	éjectés
eZakyle	éjaculés
ebERZe	hébergés
ebR2	hébreux
ebR8ite	ébruitée
ebR@le	ébranlés
ebluiR	éblouirent
eboS	ébauches
ede	aider
edifis	édifices
edyke	éduqués
ef)dRe	effondrés
efE	effets
efEkt8e	effectués
efOR	efforts
efR)te	effrontés
efREje	effrayés
efRwa	effroi
efase	effacés
efemER	éphémères
efiZi	effigies
efikas	efficaces
efl9Re	effleurés
eg8ij	aiguilles
egRatiNyR	égratignures
egRi	aigrit
egaR	égares
egal	égales
egeje	égayer
egize	aiguisés
egliz	églises
ego	égaux
egoist	égoïstes
egu	égouts
egy	aiguës
ek8El	écuelles
ek8ije	écuyers
ek9Re	écoeurés
ekORSe	écorchés
ekORs	écorces
ekOl	écoles
ekR(vis	écrevisses
ekR@	écrans
ekRabuje	écrabouillés
ekRaze	écrasés
ekRiR	écrire
ekRito	écriteaux
ekRityR	écritures
ekRiv5	écrivains
ekRule	écroulés
ekaR	écarts
ekaj	écailles
ekilibR	équilibres
ekip	équipes
ekitabl	équitables
ekival@	équivalents
eklER	éclairs
ekla	éclats
eklips	éclipses
eklo	éclos
ekogRafi	échographie
ekonomi	économies
ekope	écopée
eksEl@	excellent
ekuRte	écourtés
ekule	écoulés
ekut	écoutes
ekutij	écoutilles
eky	écus
ekyR9j	écureuils
ekyRi	écuries
ekym	écumes
el@	élans
el@se	élancés
elEktRisite	électricité
elEv	élèves
elOZ	éloges
elaboRe	élaborés
elastik	élastiques
ele	hélés
eleg@s	élégances
eliR	élire
elikOptER	hélicoptères
eliksiR	élixirs
elimine	éliminés
elis	hélices
elit	élites
elje	ailiers
elok@s	éloquence
ely	élut
elyside	élucidés
em2t	émeutes
emERZe	émergés
emane	émanés
eme	aimés
emigRe	émigrés
emin@	éminents
emisj)	émissions
emuvwaR	émouvoir
emwa	émois
emy	émût
en)se	énoncés
enERZi	énergies
enERve	énervés
enORm	énormes
ene	henné
enigm	énigmes
ep(R)	éperons
ep(le	épelés
ep)Z	éponges
ep5gl	épingles
ep8ize	épuisés
epE	épais
epOk	époques
epR9v	épreuves
epR@dR	éprendre
epRuve	éprouvés
epaRN	épargnes
epaRpije	éparpillés
epanwiR	épanouirent
epate	épatés
epav	épaves
epe	épées
epesiR	épaissir
epi	épis
epidemi	épidémies
epilEpsi	épilepsie
epinaR	épinards
epise	épissé
epizOd	épisodes
epje	épiés
eplySe	épluchés
epol	épaules
epope	épopées
epu	époux
epuv@t	épouvantes
epuze	épousés
es8ije	essuyés
es@s	essences
es@sjEl	essentiels
esE	essais
eseje	essayez
est	est
et5	éteints
et5dR	éteindre
et5s(le	étincelé
et8i	étuis
et@	étends
et@S	étanches
et@dR	étendre
etER	éthers
etERn8e	éternué
etERnEl	éternels
etOf	étoffes
etR5dR	étreindre
etR5t	étreintes
etR@Z	étranges
etR@gle	étranglés
etRipe	étripés
etRwa	étroits
etaZ	étages
etaZER	étagères
etabliR	établirent
etale	étalés
etap	étapes
ete	étés
eteRo	hétéros
etiRe	étirés
etik	étiques
etikEt	étiquettes
etone	étonnés
etuRdiR	étourdirent
etufe	étouffés
etwal	étoiles
etyd	études
ev5se	évincés
ev@Zil	évangiles
ev@t8El	éventuels
ev@tRe	éventrés
ev@taj	éventails
evEj	éveils
evEk	évêques
evade	évadés
evak8e	évacués
eval8e	évalués
evanuiR	évanouir
evapoRe	évaporés
eveje	éveillés
evid@	évidents
evite	évités
evje	éviers
evoke	évoqués
evol8e	évolués
eze	aisés
ezite	hésité
f(mEl	femelles
f(nEtR	fenêtres
f(nuj	fenouil
f)	fonts
f)dR	fondre
f)de	fondés
f)dy	fondus
f)se	foncés
f)tEn	fontaines
f1k	funk
f2	feux
f2tR	feutres
f2z@	faisan
f5	fins
f5dR	feindre
f5t	feintes
f8iR	fuirent
f8ijaR	fuyards
f8it	fuites
f9j	feuilles
f9j(t)	feuilletons
f9nki	funky
f@dR	fendre
f@f@	fanfan
f@faR	fanfares
f@t	fentes
f@tasm	phantasmes
f@tastik	fantastiques
f@tezi	fantaisies
f@tom	fantômes
fE	faix
fER	fère
fERaj	ferrailles
fERi	ferry
fERm	fermes
fERm(te	fermeté
fERovjER	ferroviaires
fERtil	fertiles
fERv9R	ferveurs
fERv@	fervents
fEbl	faibles
fEn	faînes
fEso	faisceaux
fEst5	festins
fEstival	festivals
fEstwaje	festoyé
fEt	fêtes
fEv	fèves
fOR	forts
fORZ	forges
fORZ(R)	forgerons
fORfE	forfaits
fORm	formes
fORma	formats
fORmyl	formules
fORsa	forçât
fORse	forcés
fORt8i	fortuits
fORtiS	fortiches
fORtyn	fortunes
fOk	phoques
fOlk	folks
fOs	fosses
fOsfOR	phosphore
fOt	phot
fR(done	fredonnés
fR)	fronts
fR)d	frondes
fR)tjER	frontières
fR5	freins
fR5g	fringues
fR8i	fruits
fR@	francs
fR@SiR	franchirent
fR@Siz	franchises
fR@Z5	frangins
fR@bwaz	framboises
fRE	frets
fRER	frères
fRES9R	fraîcheurs
fREj9R	frayeurs
fREl	frêles
fREn	frênes
fREsk	fresques
fREze	fraiser
fROk	frocs
fRaZil	fragiles
fRagm@	fragments
fRaka	fracas
fRakase	fracassés
fRaktyR	fractures
fRap	frappes
fRaz	phrases
fReRo	frérots
fReje	frayée
fRek@	fréquents
fRemiR	frémirent
fRene	freinés
fRenezi	frénésies
fRiR	frire
fRiZidER	frigidaires
fRigo	frigos
fRij@diz	friandises
fRik	frics
fRikadEl	fricadelles
fRikote	fricoté
fRime	frimés
fRipuj	fripouilles
fRis)	frissons
fRisbi	frisbee
fRit	fritte
fRityR	fritures
fRivOl	frivoles
fRiz9R	friseur
fRize	frisés
fRod	fraudes
fRole	frôlés
fRomaZ	fromages
fRote	frottés
fRus	frousses
fRwa	froids
fRwase	froissés
fRystRe	frustrés
faR	phares
faRa)	pharaons
faRdo	fardeaux
faRf(ly	farfelus
faRfuje	farfouillé
faRin	farines
faRizj5	pharisiens
faRmasi	pharmacies
faRsiR	farcir
faRuS	farouches
faSe	fâchés
faSo	fachos
fabRik	fabriques
fad	fades
fada	fadas
fado	fado
faj	failles
fak	facs
fakse	faxés
fakt9R	facteurs
faktyR	factures
fakylte	facultés
fal@Z	phalanges
falEz	falaises
falsifje	falsifiés
falwaR	falloir
fam	femmes
famij	familles
famin	famines
fan	fans
fani	fanny
fas)	façons
fasad	façades
fasil	faciles
fasine	fascinés
fastOS	fastoche
fat	fats
fatig	fatigues
fav9R	faveurs
favela	favelas
favoRi	favoris
fe	fées
feROs	féroces
febliR	faiblir
fedeRal	fédérales
fek)de	fécondés
fele	fêlée
felisite	félicités
femin5	féminins
femyR	fémurs
fenomEn	phénomènes
fese	fessée
fetiS	fétiches
fetid	fétides
fetys	foetus
fevRije	février
fiRm	firmes
fiS	fiches
fiSy	fichus
fiZe	figés
fibR	fibres
fidEl	fidèles
fig	figues
figyR	figures
fij	filles
fij9l	filleuls
fij@saj	fiançailles
fiks	fixes
fil	fils
fil)	filons
filE	filets
filatyR	filatures
film	films
filozOf	philosophes
filtR	philtres
filu	filous
fin	fines
fin@s	phynances
final	finals
finiR	finirent
fis	fissent
fisEl	ficelles
fisa	fissa
fisk	fisc
fist)	fistons
fisyR	fissures
fizik	physiques
fj)	fions
fj@se	fiancés
fjER	fières
fjEf	fiefs
fjEl	fiel
fjEsta	fiestas
fjEvR	fièvres
fjORd	fjords
fjOl	fioles
fjakR	fiacres
fjasko	fiascos
fje	fiés
fjul	fuel
fl5g	flingues
fl8id	fluides
fl9R	fleurs
fl9Rt	flirts
fl9S	flush
fl9v	fleuves
fl@	flans
fl@Se	flanché
fl@ke	flanqués
flER	flaires
flES	flèches
flEksibl	flexibles
flOt	flottes
fla	flats
flaS	flashs
flak	flaques
flak)	flacons
flam	flammes
flam@	flamants
flamEnko	flamencos
flane	flâné
flask	flasques
flat(Ri	flatteries
fleR	flairés
fleSiR	fléchirent
fleo	fléaux
fletRiR	flétrirent
flik	flics
flip	flips
flo	flots
flok)	flocons
flu	flous
fly	flux
flyt	flûtes
fo	faux
foR5	forains
foRE	forêts
foROm	forums
foRe	forés
foSe	fauchés
fobi	phobies
fobuR	faubourgs
fofile	faufilés
fok)	faucons
foli	folies
fosER	faussaires
fose	fossés
fosil	fossiles
fot	fautes
fot9j	fauteuils
fotogRaf	photographes
fov	fauves
fu	fout
fuR	fours
fuRS	fourches
fuRb	fourbes
fuRg)	fourgons
fuRge	fourgués
fuRjER	fourrière
fuRmi	fourmis
fuRniR	fournirent
fuRno	fourneaux
fuRyR	fourrures
fudR	foudres
fug	fougues
fuj	fouilles
ful	fulls
fulaR	foulards
fut	foutes
futEz	foutaises
futR	foutre
futbOl	football
futwaR	foutoirs
futy	foutus
fw5	foins
fwE	fouets
fwa	fois
fwaR	foires
fwete	fouettés
fwin	fouines
fy	fûts
fyR)kl	furoncles
fyR9R	führers
fyRaks	furax
fyRi	furies
fyg	fugues
fyme	fumés
fymje	fumiez
fyn	fun
fynEbR	funèbres
fynEst	funestes
fyneRER	funéraires
fyneRaj	funérailles
fytil	futiles
fytyR	futurs
fyze	fusées
fyzi	fusils
fyzibl	fusibles
g)bo	gombos
g)dOl	gondoles
g)fle	gonflés
g)g	gongs
g5	gains
g9l	gueules
g9n	guns
g@g	gangues
g@gREn	gangrènes
g@gstER	gangsters
gE	guets
gER	guère
gEn	gaines
gEp	guêpes
gEto	ghettos
gORZ	gorges
gOldEn	goldens
gOlf	golfs
gOm	gommes
gOs	gosses
gR(d5	gredins
gR(lote	grelottée
gR(nad	grenades
gR(nje	greniers
gR(nuj	grenouilles
gR)de	grondés
gR5	grains
gR5p	grimpent
gR5se	grincé
gR@	grands
gR@Z	granges
gREf	greffes
gREk	grecs
gREl	grêles
gREn	grène
gREs	graisses
gREv	grèves
gROt	grottes
gRa	gras
gRabyZ	grabuge
gRad	grades
gRad5	gradins
gRafiti	graffitis
gRam	grammes
gRamER	grammaires
gRamofOn	gramophones
gRanit	granits
gRap	grappes
gRap5	grappins
gRat5	gratins
gRat8i	gratuits
gRatityd	gratitudes
gRatos	gratos
gRav	graves
gRaviR	gravirent
gRavyR	gravures
gRe	gré
gRefe	greffés
gRese	graisser
gRi	gris
gRiGo	gringo
gRiNote	grignotés
gRif	griffes
gRij	grilles
gRil	grils
gRimas	grimasse
gRin	greens
gRip	grippes
gRiv	grives
gRize	grisés
gRo	gros
gRoNe	grognées
gRotEsk	grotesques
gRozEj	groseilles
gRuje	grouillées
gRum	groume
gRup	groups
gRy	grues
gRyjER	gruyère
ga	ghât
gaNe	gagnés
gaR	gares
gaR@tiR	garantir
gaRd	gardes
gaRd)	gardons
gaRdj5	gardiens
gaRniR	garnirent
gaRniz)	garnisons
gaRo	garrots
gaRs)	garçons
gaSEt	gâchettes
gaSe	gâchés
gaSi	gâchis
gaZ	gages
gadZEt	gadgets
gaf	gaffes
gag	gags
gajaR	gaillards
gal	galles
gal)	galons
galE	galets
galEt	galettes
gala	galas
galaksi	galaxies
galo	galops
galope	galopé
gam	gammes
gam5	gamins
gamEl	gamelles
gama	gammas
gaspatSo	gazpacho
gaspije	gaspillés
gat(Ri	gâteries
gato	gâteaux
gave	gavés
gaz)	gazons
gazEl	gazelles
gaze	gazés
geRiR	guérir
geRija	guérillas
geRiz)	guérisons
geSa	geishas
gete	guettés
gi	gui
giNOl	guignols
giRl@d	guirlandes
giSE	guichets
gid	guides
gid)	guidons
gijotin	guillotines
gimov	guimauves
gine	guinées
gitaR	guitares
gl@	glands
gl@d	glandes
glEv	glaives
glEz	glaises
glOb	globes
glObyl	globules
gla	glas
gladjat9R	gladiateurs
glamuR	glamour
glane	glanés
glas)	glaçons
glis	glisses
gliseRin	glycérine
glok	glauques
glut)	gloutons
glwaR	gloires
glykoz	glucose
gnom	gnomes
go	goths
goRij	gorilles
goS	gauches
gobe	gobés
godas	godasses
gofR	gaufres
gogo	gogos
gol	goals
golwa	gaulois
gon	gone
gozje	gosiers
gu	goûts
guRd	gourdes
guRd5	gourdins
guRe	gourés
guRm@	gourmands
guRu	guru
guZa	goujats
gudR)	goudrons
gufR	gouffres
gut	goûtes
guvERne	gouvernés
gys	gusse
iNObl	ignobles
iNoRe	ignorés
iRis	iris
iRite	irrités
iRoni	ironies
iRsyt	hirsutes
iZjEn	hygiènes
ibRid	hybrides
ibu	hiboux
id@tite	identités
idEm	idem
idOl	idoles
idRolik	hydrauliques
ide	idées
idil	idylles
idjo	idiots
if	ifs
iglu	igloos
ik	hic
ikon	icônes
il	îles
iliko	illico
ilystR	illustres
ilyzj)	illusions
im@s	immenses
imERZe	immergés
imEn	hymen
imaZ	images
imaZine	imaginés
imakyle	immaculés
imam	imams
imedja	immédiats
imin@	imminents
imise	immiscée
imite	imités
imn	hymnes
imole	immolés
imynize	immunisés
in)de	inondés
inEpsi	inepties
inedi	inédits
inisjal	initiales
inisjativ	initiatives
inisje	initiés
inogyRe	inaugurés
inos@	innocents
inwi	inouïs
inyme	inhumés
ipi	hippy
ipnotize	hypnotisés
ipokRit	hypocrites
ipopotam	hippopotames
ipotEk	hypothèques
ipotEz	hypothèses
ise	hissés
isi	ici
islam	islam
isteRi	hystéries
istwaR	histoires
isy	issus
it	hits
itineRER	itinéraires
ivER	hivers
ivR	ivres
ivwaR	ivoires
izole	isolés
j@g	yang
jER	hier
jOd	iode
ja	ya
jaR	yards
jak	yaks
jauRt	yaourts
jeRaRSi	hiérarchies
jeRoglif	hiéroglyphes
joga	yoga
jupi	yuppies
jyan	yuans
k(REl	querelles
k)	cons
k)Z(le	congelés
k)Ze	congés
k)Zedje	congédiés
k)ZyRe	conjurés
k)Zygal	conjugales
k)ba	combats
k)bin	combines
k)bj5	combien
k)bl	combles
k)bystibl	combustibles
k)d8iR	conduire
k)dOR	condors
k)dane	condamnés
k)dole@s	condoléances
k)f)dR	confondre
k)f5	confins
k)fOR	conforts
k)fORm	conformes
k)fR)te	confrontés
k)fRER	confrères
k)fReRi	confréries
k)feRe	conférés
k)fese	confessés
k)feti	confettis
k)fiRme	confirmés
k)fid@	confidents
k)fine	confinés
k)fiske	confisqués
k)fityR	confitures
k)fje	confiés
k)fli	conflits
k)fy	confus
k)gRE	congrès
k)k)bR	concombres
k)kEt	conquêtes
k)kOkte	concoctés
k)kRE	concrets
k)klyzj)	conclusions
k)kuR	concourt
k)kuRiR	concourir
k)kyR@	concurrents
k)kyb5	concubins
k)p@se	compensés
k)pER	compères
k)pORte	comportés
k)pOt	compotes
k)pR@dR	comprendre
k)pREs	compresses
k)pRi	comprît
k)pRime	comprimés
k)pRomEtR	compromettre
k)pRomi	compromît
k)pa	compas
k)paN)	compagnons
k)paREtR	comparaître
k)paREz)	comparaisons
k)paRe	comparés
k)pakt	compacts
k)patRijOt	compatriotes
k)patiR	compatirent
k)patibl	compatibles
k)pet@	compétents
k)plE	complets
k)plEks	complexes
k)plete	complétés
k)plike	compliqués
k)plis	complices
k)plo	complots
k)poze	composés
k)s(vwaR	concevoir
k)s@tRe	concentrés
k)s@tiR	consentirent
k)sER	concerts
k)sERne	concernés
k)sERto	concertos
k)sERv	conserves
k)sEj	conseils
k)sEpt	concepts
k)sOl	consoles
k)sakRe	consacrés
k)sede	concédés
k)seje	conseillés
k)sek@	conséquents
k)si	concis
k)siN	consignes
k)sideRe	considérés
k)siste	consisté
k)sj@	conscients
k)sjERZ	concierges
k)sole	consolés
k)solide	consolidés
k)some	consommés
k)spiRe	conspiré
k)st@t	constantes
k)stR8iR	construire
k)sta	constats
k)stit8e	constitués
k)syl	consuls
k)syme	consumés
k)t	contes
k)t(Rakte	contracter
k)t(niR	contenir
k)t(ny	contenus
k)t@	contents
k)t@ple	contemplés
k)t@poR5	contemporains
k)tEkst	contextes
k)tEnER	container
k)tEste	contestés
k)tR	contres
k)tR5t	contraintes
k)tRER	contraires
k)tRa	contrats
k)tRaRje	contrariés
k)tRib8e	contribué
k)tRol	contrôles
k)tRovERs	controverses
k)taZj)	contagion
k)takt	contacts
k)tamine	contaminés
k)tin	comptines
k)tin8e	continués
k)tin@	continents
k)tiny	continus
k)tuR	contours
k)tuRne	contournés
k)twaR	comptoirs
k)tyzj)	contusions
k)v(n@s	convenances
k)v(niR	convenir
k)v5kR	convaincre
k)vERtiR	convertir
k)vales@s	convalescences
k)vje	conviés
k)voke	convoqués
k)vwa	convois
k)vwatiz	convoitises
k2	queues
k5kaj(Ri	quincailleries
k5t	quintes
k5zEn	quinzaines
k8iR	cuirs
k8iRas	cuirasses
k8ijER	cuillères
k8is)	cuissons
k8isto	cuistots
k8it	cuites
k8ivR	cuivres
k8izin	cuisines
k9R	coeurs
k9jiR	cueillirent
k@	quant
k@bRe	cambrés
k@bRus	cambrousses
k@d9R	candeurs
k@dida	candidats
k@didatyR	candidatures
k@guRu	kangourous
k@k@	cancans
k@paN	campagnes
k@pe	campés
k@piG	campings
k@pys	campus
k@sER	cancers
k@tik	cantiques
k@tin	cantines
k@tite	quantités
kE	quai
kEk	cakes
kElk	quelques
kElk)k	quelconques
kEs)	caissons
kEstjon	questionnés
kEt	quêtes
kEtS9p	ketchup
kOR	cors
kORbEj	corbeilles
kORbijaR	corbillards
kORbo	corbeaux
kORd	cordes
kORd)	cordons
kORn	cornes
kORn(myz	cornemuses
kORniS)	cornichons
kORsaZ	corsages
kORse	corsés
kORtEZ	cortèges
kORtEks	cortex
kORtizOn	cortisone
kORvEt	corvettes
kORve	corvées
kOS	coches
kOd	codes
kOfR	coffres
kOk	coques
kOk(liko	coquelicots
kOk(lyS	coqueluches
kOkpit	cockpit
kOktEl	cocktails
kOl	cols
kOlmate	colmatés
kOltine	coltinés
kOm	comme
kOn(Ri	conneries
kOsmonot	cosmonautes
kOstaR	costards
kOsto	costaux
kOstym	costumes
kOt	kot
kR(vEt	crevettes
kR(vas	crevasses
kR(ve	crevés
kR2ze	creusés
kR5dR	craindre
kR5t	craintes
kR@	crans
kR@p	crampes
kR@p)	crampons
kRE	crêt
kRENos	craignos
kRES	crèches
kREm	crèmes
kREp	crêpes
kREt	crêtes
kREv	crèves
kROs	crosses
kROt	crottes
kRaSa	crachats
kRab	crabes
kRad	crades
kRak(l5	craquelins
kRame	cramés
kRan	crânes
kRapo	crapauds
kRapyl	crapules
kRas	crasses
kRatER	cratères
kRavat	cravates
kReSe	crécher
kReatyR	créatures
kRedi	crédits
kRedibl	crédibles
kRedyl	crédules
kRee	créés
kRemajER	crémaillères
kReno	créneaux
kRepite	crépité
kRepyskyl	crépuscules
kRet5	crétins
kRetj5	chrétiens
kRi	cris
kRible	criblés
kRikE	criquets
kRikEt	crickets
kRim	crimes
kRinjER	crinières
kRipt	cryptes
kRipt)	krypton
kRise	crissé
kRispe	crispés
kRist	christs
kRistal	cristal
kRitER	critères
kRitike	critiqués
kRo	crocs
kRoke	croqués
kRoki	croquis
kRokodil	crocodiles
kRonometR	chronométrés
kRule	croulés
kRupiR	croupir
kRut	croûtes
kRwa	croît
kRwaR	croire
kRwatR	croître
kRwazad	croisades
kRwaze	croisés
kRwazjER	croisières
kRy	crût
kRyEl	cruels
kRyS	cruches
kRyote	cruautés
kRysifi	crucifix
kRysjal	cruciales
ka	ka
kaNOt	cagnotte
kaR	quarts
kaR(fuR	carrefours
kaR@t	quarante
kaROs	carrosses
kaROt	carottes
kaRa	carra
kaRabin	carabines
kaRaf	carafes
kaRaktER	caractères
kaRamEl	caramels
kaRapas	carapaces
kaRavan	caravanes
kaRbOn	carbones
kaRdinal	cardinales
kaRgEz)	cargaisons
kaRgo	cargos
kaRij)	carillons
kaRikatyR	caricatures
kaRjER	carrières
kaRjOl	carrioles
kaRkas	carcasses
kaRma	karma
kaRn	carnes
kaRnE	carnets
kaRnaZ	carnages
kaRnaval	carnavals
kaRo	carreaux
kaRp	carpes
kaRseRal	carcérales
kaRt	quarte
kaRt)	cartons
kaRtER	carters
kaRtEl	cartels
kaRtabl	cartables
kaRtone	cartonnés
kaRtuS	cartouches
kaS	cash
kaS(miR	cachemires
kaSE	cachets
kaSo	cachots
kaZ	cages
kaZo	cageots
kaZole	cajolés
kabOS	caboches
kabaRE	cabarets
kaban	cabanes
kabin	cabines
kabl	câbles
kabo	cabots
kad(na	cadenas
kad@s	cadences
kadE	cadets
kadR	cadres
kadR@	cadrant
kadavR	cadavres
kadi	kadi
kado	cadeaux
kafaR	cafards
kafe	cafés
kafte	caftés
kagul	cagoules
kaid	caïds
kaim@	caïmans
kaj	cailles
kaju	cailloux
kaka	cacas
kakao	cacaos
kakawEt	cacahuètes
kaktys	cactus
kal	cals
kal(p5	calepins
kal5	câlins
kal@dRije	calendriers
kalES	calèches
kalOmni	calomnies
kalamaR	calamars
kalibR	calibres
kalif	khalife
kalis	calices
kalite	qualités
kalkyl	calculs
kalm	calmes
kalmaR	calmars
kaloRi	calories
kals)	caleçons
kalvER	calvaires
kalvisi	calvities
kam	cames
kam(lOt	camelotes
kamaRad	camarades
kameRa	caméras
kamele)	caméléons
kamikaz	kamikazes
kamizOl	camisoles
kamomij	camomilles
kamufle	camouflés
kan	khans
kan)	canons
kanEl	cannelle
kanaR	canards
kanaRi	canaris
kanabis	cannabis
kanaj	canailles
kanal	canal
kanape	canapés
kaniS	caniches
kanibal	cannibales
kanivo	caniveaux
kanjOn	canyons
kano	canots
kanylaR	canulars
kao	k-o
kap	caps
kapOt	capotes
kapRis	caprices
kapabl	capables
kapitEn	capitaines
kapital	capitales
kapityle	capitulé
kapo	kapos
kapoRal	caporale
kapsyl	capsules
kaptif	captifs
kaptive	captivés
kaptyR	captures
kapyS	capuches
kapyS)	capuchons
kas(ROl	casseroles
kasEt	cassettes
kase	cassés
kask	casques
kaskad	cascades
kastOR	castors
kastRe	castrés
kastiG	castings
kat5	catins
katS	catch
katak)b	catacombes
katal@	catalans
katapylt	catapultes
katastROf	catastrophes
katedRal	cathédrales
kategoRi	catégories
katolik	catholiques
kautSu	caoutchoucs
kav	caves
kaval	cavales
kavite	cavités
kavjaR	caviar
kavo	caveaux
kazERn	casernes
kaza	casas
kazi	quasi
kazino	casinos
kepi	képis
ki	qui
kiS	quiches
kidnapiG	kidnappings
kif	kif
kij	quilles
kil9R	killer
kilo	kilos
kimono	kimonos
kine	kiné
kit	quittes
kjOsk	kiosques
kl5	clins
kl9b	clubs
kl@	clans
kl@dEst5	clandestins
kl@p	clamps
klER	clercs
klER)	clairons
klERZe	clergés
klERjER	clairières
klEps	klebs
klOR	clore
klOS	cloches
klOk	cloques
klOne	cloner
klOp	clopes
klaRinEt	clarinettes
klaRte	clartés
klaS	clash
klak	claques
klakEt	claquettes
klaks)	klaxons
klame	clamés
klap	clappe
klas	classes
klavikyl	clavicules
klavje	claviers
kle	clés
klebaR	clébards
klem@s	clémence
kliNe	clignés
kliSe	clichés
klij@	clients
klik	cliques
klima	climats
klin	clean
klinEks	kleenex
klip	clips
klitoRis	clitoris
klo	clôt
kloSaR	clochards
kloSe	cloché
klodo	clodos
klon	clones
klotyR	clôtures
klu	clous
klwaz)	cloisons
ko5side	coïncidé
koNak	cognacs
koNe	cognés
koORdone	coordonnés
koR)pR	corrompre
koR)py	corrompus
koREkt	corrects
koREsp)dR	correspondre
koRaj	corail
koRal	corrals
koRe5	coréens
koRegRafi	chorégraphies
koRiZe	corrigés
koRidOR	corridors
koRida	corridas
koRjas	coriaces
koRoboRe	corroborées
koRonER	coroners
koS(maR	cauchemars
koS)	cochons
koSe	cochés
koabite	cohabité
kobRa	cobras
kobaj	cobayes
kode	codés
koeR@	cohérents
kofRe	coffrés
kojOt	coyotes
kok	cokes
kok)	cocons
kok5	coquins
kokE	coquets
koka	cocas
kokain	cocaïne
kokij	coquilles
koko	cocos
kokoRiko	cocoricos
koksinEl	coccinelles
koky	cocus
kol)	côlon
kol)b	colombes
kolER	colères
kolEZ	collèges
kolEg	collègues
kolEkt	collectes
kolOn	colonnes
kolOs	colosses
kolaZEn	collagène
kolaboRe	collaboré
kold	cold
kole	colée
koleRa	choléras
koliN)	collignon
kolik	coliques
kolin	collines
kolizj)	collisions
kolje	colliez
kolo	colos
koloRe	colorés
koloRje	coloriés
kolonEl	colonels
kom1	communs
kom@	comment
kom@de	commandés
kom@se	commencés
kom@tER	commentaires
komERs	commerces
komEstibl	comestibles
komEt	comètes
komEtR	commettre
komOd	commodes
koma	comas
komi	komi
komisER	commissaires
komodOR	commodores
komyn	communes
komynike	communiqués
komynote	communautés
kon	cônes
konEksj)	connexions
konEtR	connaître
konaR	connards
konas	connasses
kony	connût
koopeRativ	coopératives
koopeRe	coopéré
kop5	copains
kopEk	kopeks
kopi	copies
kopyle	copulé
kot	côtes
kotS	coachs
kota	quotas
kotaZ	cottages
kotidj5	quotidiens
kotwaje	côtoyés
koz	causes
kozak	cosaques
ku	coûts
kuR	courts
kuROn	couronnes
kuRZ	courges
kuRaZ	courages
kuRb	courbes
kuRiR	courir
kuRse	coursés
kuRtize	courtisées
kuRtwa	courtois
kuRwa	courroies
kuS	couches
kud	coudes
kudR	coudre
kuf5	couffins
kuj	couilles
kuki	cookie
kuku	coucous
kul	coules
kul9R	couleurs
kulis	coulisses
kulwaR	couloirs
kup	coupes
kup)	coupons
kupOl	coupoles
kupl	couples
kuplE	couplets
kupyR	coupures
kus5	coussins
kuskus	couscous
kuto	couteaux
kutyR	coutures
kutym	coutumes
kuv@	couvents
kuvER	couverts
kuve	couvés
kuz5	cousins
kuzy	cousus
kw5	coins
kw5se	coincés
kw@tik	quantiques
kwEt	couettes
kwa	quoi
kwaf	coiff
kwak(	quoique
kwat8OR	quatuors
kwine	couiné
kyR	cures
kyRi	curry
kyb	cubes
kyb5	cubains
kylOt	culottes
kylbyt	culbutes
kylo	culots
kylt	cultes
kyltyR	cultures
kypid	cupides
kytER	cutters
kyv	cuves
l(s)	leçons
l(ve	levés
l)	longs
l1di	lundis
l2semi	leucémies
l5	lins
l5Se	lynchés
l5Z	linges
l5go	lingots
l5ks	lynx
l5pid	limpides
l5s9l	linceuls
l89R	lueurs
l8iR	luirent
l9R	leurs
l@	lents
l@Ze	langée
l@bo	lambeaux
l@d	lands
l@do	landaus
l@g	langues
l@gaZ	langages
l@giR	languirent
l@gust	langoustes
l@p	lampes
l@se	lancés
l@sk(nE	lansquenets
l@t9R	lenteurs
l@tERn	lanternes
l@tij	lentilles
lE	lès
lES	lèches
lEd9R	laideurs
lEg	lègue
lEjdi	lady
lEktyR	lectures
lEn	laines
lEpR	lèpres
lEtR	lettres
lEvR	lèvres
lEzbj5	lesbien
lOR	lors
lORNe	lorgnés
lORd	lord
lORsk(	lorsque
lOZ	loges
lOb	lobs
lOft	loft
lOk	loques
lOp	lopes
la	là
laR	lares
laRZ	larges
laRZ9R	largeurs
laRb5	larbins
laRge	largués
laRm	larmes
laRv	larves
laS	lâches
laS(te	lâchetés
lab9R	labeurs
labEl	labels
labiR5t	labyrinthes
laboRatwaR	laboratoires
labuRe	labourés
lagyn	lagunes
lajt	light
lajys	laïusse
lak	laques
lakE	laquait
lam	lames
lam@te	lamentés
lama	lamas
lap)	lapons
lap5	lapins
lape	lapées
lase	lassés
laseRe	lacérés
lasif	lascifs
lasityd	lassitudes
laskaR	lascars
laso	lassos
lat	lattes
lat5	latins
lat@	latents
latEks	latex
latino	latinos
latityd	latitudes
lav	laves
lav@d	lavandes
lavabo	lavabos
lazER	lasers
lazaN	lasagnes
le	lés
leSe	léchés
leZ@d	légendes
leZe	légers
leZitim	légitimes
legal	légales
lege	légués
legym	légumes
leopaR	léopards
lese	laissés
lesiv	lessives
lety	laitues
lezaR	lézards
leze	lésés
lezine	lésiné
liN	lignes
liR	lyres
libERt5	libertins
libERte	libertés
libR	libres
libRER	libraires
libeRal	libérales
libeRe	libérés
libelyl	libellule
libido	libido
lid9R	lieder
liftiG	liftings
lig	ligues
ligote	ligotés
lik9R	liqueurs
likORn	licornes
likefje	liquéfiés
likid	liquides
lila	lilas
lim	limes
limas	limaces
limit	limites
limonad	limonades
limuz5	limousins
lin	line
lise	lycées
list)	liston
litR	litres
liteRatyR	littératures
liv	live
livR	livres
lj2	lieux
lj5	liens
ljEs	liesses
ljEvR	lièvres
ljEz)	liaisons
ljas	liasses
lje	liés
lo	lots
loRje	lauriers
loZe	logés
loZi	logis
loZisjEl	logiciels
logo	logo
lokalize	localisés
lokatER	locataires
loko	locos
lokomotiv	locomotives
lolo	lolos
loto	lotos
loze	loser
lu	loups
luS	louches
lubaR	loubards
luk	look
lulu	loulous
lup	loupes
lutR	loutres
lw5	loin
lw@Z	louanges
lwa	loua
lwajote	loyautés
lwaziR	loisirs
lwe	loués
lwi	louis
ly	lût
lyZ	luges
lybRik	lubriques
lybi	lubies
lygybR	lugubres
lyks	luxes
lyksyR	luxure
lymjER	lumières
lyn	lunes
lynEt	lunettes
lypys	lupus
lysjOl	lucioles
lystR	lustres
lyt	luttes
lyt5	lutins
m(l)	melons
m(nOt	menottes
m(nas	menassent
m(ne	menés
m(no	meneaux
m(ny	menus
m(sj2	monsieur
m(zyR	mesures
m)	monts
m)d	mondes
m)d5	mondains
m)stR	monstres
m)tR	montres
m)taN	montagnes
m)tyR	montures
m2	meut
m2l	meules
m2t	meutes
m5	maints
m5tOR	mentors
m5tj5	maintient
m8E	muets
m8e	mués
m9Rs	moeurs
m9RtR	meurtres
m9bl	meubles
m9f	meufs
m9fin	muffin
m9st	must
m@	ment
m@S	manches
m@So	manchots
m@Ze	mangés
m@bR	membres
m@bRan	membranes
m@bo	mambos
m@da	mandats
m@daRin	mandarines
m@dala	mandalas
m@de	mendé
m@dje	mendiées
m@g	mangues
m@k	manques
m@s)Z	mensonges
m@s8El	mensuels
m@t	menthes
m@t)	mentons
m@tiR	mentir
m@to	mentaux
mE	mets
mER	mères
mERd	merdes
mERkR(di	mercredis
mERkyR	mercure
mERl	merles
mERl@	merlans
mERlo	merlot
mERs(nER	mercenaires
mERsi	mercis
mERvEj	merveilles
mES	mèches
mEds5	médecins
mEdsin	médecines
mEgR	maigres
mEj9R	meilleurs
mEjl	mails
mEk	mecs
mEksik5	mexicains
mEm	mêmes
mEsk5	mesquins
mEtR	mètres
mEz)	maisons
mOR	morts
mORdR	mordre
mORdy	mordus
mORf)dR	morfondre
mORfin	morphine
mORfle	morflée
mORn	mornes
mORpj)	morpions
mORso	morceaux
mORsyR	morsures
mORtje	mortiers
mORv	morves
mOS	moches
mOd	modes
mOk(Ri	moqueries
mOl	mols
mOske	mosquées
ma	mâts
maEstRo	maestro
maNanim	magnanimes
maNetik	magnétiques
maNifik	magnifiques
maR	marres
maR)	marrons
maR5	marins
maRE	marrait
maREn	marraines
maRS	marches
maRSal	marshals
maRZ	marges
maRat)	marathons
maRbR	marbres
maRdi	mardis
maReSal	maréchale
maRekaZ	marécages
maRg(Rit	marguerites
maRgo	margot
maRi	mary
maRiRwana	marijuana
maRin	marines
maRitim	maritimes
maRjonEt	marionnettes
maRk	marques
maRketiG	marketings
maRki	marquis
maRmOt	marmottes
maRmit	marmites
maRmo	marmots
maRmone	marmonnés
maRok5	maroquins
maRt(le	martelés
maRt5	martins
maRtiR	martyrs
maRtini	martinis
maRto	marteaux
maS5	machins
maSEt	machettes
maSe	mâchés
maSin	machines
maSwaR	mâchoires
maZ	mages
maZ9R	majeurs
maZEste	majestés
maZOR	majors
maZisj5	magiciens
maZistRa	magistrats
maZistRal	magistrales
maZistRatyR	magistratures
maZoREt	majorettes
maZoRdOm	majordomes
maaRadZa	maharajahs
madOn	madones
madam	mme
mafja	mafias
magaz5	magasins
magazin	magazines
magnOm	magnums
mago	magots
maguj	magouilles
mais	maïs
maj	mailles
majl	mile
majo	mayo
majonEz	mayonnaises
mak	maques
mak(Ro	maquereaux
makEt	maquettes
makaRoni	macaronis
makabR	macabres
makabe	macchabées
makak	macaques
maksi	maxis
maksimOm	maximums
makymba	macumba
mal	mâles
mal5	malins
mal9R	malheurs
malEz	malaises
malaRja	malarias
malabaR	malabars
malad	malades
maladi	maladies
malefik	maléfiques
malfEt9R	malfaiteurs
malfRa	malfrats
malgRe	malgré
malis	malices
malm(ne	malmenés
maltRete	maltraités
mam(l)	mamelons
mam@	mamans
mamut	mammouths
man(k5	mannequins
man8El	manuels
man9vR	manoeuvres
manEZ	manèges
manEt	manettes
manadZ9R	manager
manadZe	manager
mani	manies
manif	manifs
manifEst	manifestes
manig@se	manigancée
manipyle	manipulés
manivEl	manivelles
manjER	manières
manjak	maniaques
manje	maniés
manwaR	manoirs
manykyR	manucures
manyskRi	manuscrits
mas)	maçons
mase	massés
mask	masques
maskOt	mascottes
maskaRa	mascara
maskaRad	mascarades
mast9R	masters
mastOk	mastoc
mastyRbe	masturbés
mat	mâte
mat(la	matelas
mat(lo	matelots
mat)	matons
mat5	mâtins
matRak	matraques
matRikyl	matricules
matRis	matrices
matS	matchs
matSo	machos
matadOR	matadors
mateRjEl	matériels
mateRjo	matériaux
matematik	mathématiques
matine	mâtinés
matjER	matières
matos	matos
matu	matous
matyR	mâtures
mazut	mazout
meRidjonal	méridionales
meRit	mérites
meS@s(te	méchancetés
medOk	médocs
medaj	médailles
medite	médités
medjOkR	médiocres
medjOm	médiums
medja	médias
medyz	méduses
mefE	méfaits
mefje	méfiés
megRiR	maigrir
mega	méga
mego	mégots
mekanik	mécaniques
mekano	mécanos
mel@Z	mélanges
mel@koli	mélancolies
melas	mélasse
mele	mêlés
melodi	mélodies
meme	mémés
memoRize	mémorisés
memwaR	mémoires
menaZ	ménages
mepR@dR	méprendre
mepRi	méprît
mepRize	méprisés
mes9R	messer
mesaZ	messages
mesiR	messires
metEk	métèques
metOd	méthodes
metRiz	maîtrises
metRo	métros
metRopOl	métropoles
metafOR	métaphores
metal	métal
meteOR	météores
meteo	météo
metis	métisses
metje	métiers
miN)	mignons
miR	myrrhe
miRakl	miracles
miRt	myrtes
miRtij	myrtilles
miRwaR	miroirs
miS	miches
miZote	mijotés
midi	midis
migREn	migraines
mikROb	microbes
mikRo	micros
mikse	mixés
mikst	mixtes
mil	milles
milOR	mylord
miledi	milady
milite	milité
milj2	milieux
mim	mîmes
mimoza	mimosas
min	mines
min(RE	minerais
min8i	minuits
min9R	mineurs
minE	minets
ministR	ministres
mino	minots
minu	minous
minwa	minois
misil	missiles
misj)	missions
mist9R	mister
mistER	mystères
mistik	mystiques
mit	mythes
mitRaje	mitraillés
mitaR	mitards
mitiG	meetings
mizER	misères
mize	misé
mizeRikORd	miséricordes
mjEl	miels
mjEt	miettes
mjOS	mioches
mjole	miaulé
mo	mots
moR	maures
moRal	morales
moRoz	moroses
moRy	morues
mobil	mobiles
mod(le	modelés
modERn	modernes
modEl	modèles
modEst	modestes
modeRe	modérés
modiR	maudirent
modifje	modifiés
modyl	modules
mokEt	moquettes
moke	moqués
mol	môles
molE	mollets
molekyl	molécules
moliR	mollir
molo	mollo
mom	mômes
mom@	moments
momi	momies
monE	monnaies
monaRk	monarques
monastER	monastères
monit9R	moniteurs
monopOl	monopoles
monopoli	monopoly
monotOn	monotones
mosad	maussades
mot9R	moteurs
motEl	motels
motif	motifs
motive	motivés
moto	motos
movE	mauvais
movjEt	mauviettes
mozole	mausolées
mu	moûts
muRiR	mourir
muS	mouches
muSwaR	mouchoirs
mudR	moudre
mul	moules
mul5	moulins
muskE	mousquets
mustaS	moustaches
mustik	moustiques
mut)	moutons
mutaRd	moutardes
muvwaR	mouvoir
mw5	moins
mw5dR	moindres
mwEt	mouettes
mwa	mois
mwaj5	moyens
mwal	moelles
mwan	moines
mwano	moineaux
mwas)	moissons
mwasone	moissonnés
mwat	moites
mwaziR	moisir
mwazisyR	moisissures
myR	mûrs
myRaj	murailles
myRiR	mûrir
myRmyR	murmures
myfl	mufles
myl	mules
mylE	mulets
myltipl	multiples
myniR	munir
myskl	muscles
myt8El	mutuels
myte	mutés
mytile	mutilés
myz	muses
myzisj5	musiciens
myzo	museaux
myzylm@	musulmans
n(v2	neveux
n)	non
n)bR	nombres
n)bRil	nombrils
n2	noeuds
n2Ron	neurones
n2tR	neutres
n5	nains
n5f	nymphes
n8aZ	nuages
n8e	nuées
n8iR	nuire
n9Rs	nurses
n9f	neufs
n@	nant
nER	nerfs
nEZ	neiges
nEgR	nègres
nEktaR	nectar
nEs@s	naissances
nEt	nettes
nEtR	naître
nOR	nord
nORm	normes
nObl	nobles
nOktyRn	nocturnes
nOmine	nominer
nOn	nonnes
nOs	noces
nOstalZi	nostalgies
nOt	notes
naRge	narguées
naRin	narines
naZ	nages
naZwaR	nageoires
nabo	nabots
nada	nada
nagER	naguère
naif	naïfs
nana	nanas
nap	nappes
nasEl	nacelles
nat	nattes
natyR	natures
natyREl	naturels
navE	navets
navEt	navettes
navRe	navrés
naviR	navires
navige	navigué
naz	nazes
nazi	nazis
ne	nés
ne)	néons
ne@mw5	néanmoins
nefast	néfastes
negliZe	négligés
negosje	négociés
nene	nénés
nesesER	nécessaires
netwaje	nettoyés
nevRoze	névrosés
ni	nies
niS	niches
niS)	nichons
nibaR	nibards
nigo	nigauds
nikEl	nickels
nike	niqués
nikotin	nicotine
nil)	nylons
nim	nim
nivo	niveaux
njE	niait
nje	niés
noEl	noëls
noblEs	noblesses
nofRaZ	naufrages
nomad	nomades
nome	nommés
nosif	nocifs
notER	notèrent
note	notés
notily	nautilus
notis	notices
notwaR	notoires
nov@bR	novembre
nova	nova
novis	novices
noze	nausées
nuRiR	nourrirent
nuj	nouilles
nunu	nounous
nunuRs	nounours
nuvEl	nouvelles
nuvo	nouveaux
nwa	noua
nwaR	noirs
nwajad	noyades
nwajo	noyaux
nwaz(tje	noisetiers
nwe	noués
ny	nus
nyk	nuques
nyl	nuls
nymeRo	numéros
oR9R	horreurs
oR@Z	oranges
oR@Zad	orangeades
oRER	horaires
oREj	oreilles
oROR	aurores
oRa	auras
oRaZ	orages
oRakl	oracles
oRal	orales
oRat9R	orateurs
oReOl	auréoles
oReje	oreillers
oRiZin	origines
oRibl	horribles
oRifis	orifices
oRifje	horrifiés
oRiz)	horizons
oRj@te	orientés
oRoskOp	horoscopes
oSe	hoché
oZiv	ogives
oZuRd8i	aujourd'hui
oazis	oasis
ob	aubes
obERZ	auberges
obERZin	aubergines
obEn	aubaines
obEz	obèses
obeiR	obéirent
obeis@s	obéissance
obliZe	obligés
oby	obus
od9R	odeurs
odas	audaces
odimat	audimats
odj@s	audiences
odjo	audio
odoRa	odorat
of@s	offenses
ofRiR	offrirent
ofis	offices
ofisjEl	officiels
ofyske	offusqués
ogm@te	augmentés
ogyR	augures
ogyst	augustes
okE	hoquets
okaz	occases
oke	ok
oksiljER	auxiliaires
okyR@s	occurrences
okylt	occultes
okype	occupés
ol	halls
ola	ola
oliv	olives
oliv(RE	oliveraies
olokost	holocaustes
om	ohms
om(lEt	omelettes
omEtR	omettre
omaR	homards
omaZ	hommages
omisid	homicides
omo	homos
omon	aumônes
on9R	honneurs
onEt	honnêtes
onoRe	honorés
op(n	open
opORt1	opportuns
opRE	auprès
opRese	oppressées
opRime	opprimés
opeRa	opérât
opeRe	opérés
opital	hôpital
opjOm	opium
opoze	opposés
opsERve	observés
opsede	obsédés
os	hausses
ose@	océans
osi	aussi
osito	aussitôt
oskylte	auscultés
ostER	austères
ot	ôtes
ot9R	hauteurs
ot@tik	authentiques
otEl	hôtels
otOn	automnes
otOpsi	autopsies
otR	autres
otRyS	autruches
otaRi	otaries
otaZ	otages
oto	autos
otoRite	autorités
otoRize	autorisés
otomobil	automobiles
otonomi	autonomie
otuR	autours
ovER	ovaires
oval	ovales
ovyl	ovules
ozEj	oseilles
oze	osés
ozon	ozone
p(le	pelés
p(lot)	pelotons
p(lote	pelotés
p(luz	pelouses
p(lyS	peluches
p(ti	petits
p)	ponts
p)S	punch
p)dR	pondre
p)go	pongo
p)kt8El	ponctuels
p)p	pompes
p)p)	pompons
p)pEt	pompette
p)t	pontes
p)t)	pontons
p)tSo	ponchos
p1k	punks
p2	peux
p2R	peur
p2pl	peuplent
p2z@t9R	pesanteurs
p2ze	pesez
p5	pins
p5dR	peindre
p5gw5	pingouins
p5s)	pinçons
p5se	pincés
p5so	pinceaux
p5t	pintes
p5tR	peintres
p5tyR	peintures
p8@t9R	puanteurs
p8e	puer
p8eRil	puérils
p8i	puy
p8is@s	puissances
p8isk(	puisque
p8ize	puisés
p9b	pubs
p9z9l	puzzles
p@	pends
p@Se	penchés
p@dR	pendre
p@da	pandas
p@dy	pendus
p@dyl	pendules
p@flE	pamphlets
p@kEk	pancakes
p@kReas	pancréas
p@kaRt	pancartes
p@pl(mus	pamplemousses
p@se	pensés
p@t	pentes
p@t5	pantins
p@tER	panthères
p@tal)	pantalons
p@tufl	pantoufles
pE	pets
pEN	peignes
pENwaR	peignoirs
pER	pères
pER)	perrons
pERS	perches
pERdR	perdre
pERdRi	perdrix
pERdRo	perdreaux
pERdy	perdus
pERfORm@s	performances
pERfid	perfides
pERfoRe	perforés
pERkizisjone	perquisitionné
pERkyte	percutés
pERl	perles
pERmEtR	permettre
pERman@	permanents
pERmi	permît
pERokE	perroquets
pERpEt	perpète
pERpet8El	perpétuels
pERpetRe	perpétrés
pERplEks	perplexes
pERs(vwaR	percevoir
pERs8ade	persuadés
pERsOn	personnes
pERse	percés
pERsekyte	persécutés
pERseveRe	persévéré
pERsi	persil
pERsiste	persisté
pERsonEl	personnels
pERspEktiv	perspectives
pERspikas	perspicaces
pERt	pertes
pERtin@	pertinents
pERtyRbe	perturbés
pERvER	pervers
pERvERsj)	perversions
pERvERtiR	pervertir
pERyk	perruques
pES	pêches
pEgR	pègre
pEj	paye
pEk(no	péquenots
pEl	pèles
pEl(R5	pèlerins
pEn	pêne
pEnaR	peinards
pEst	pestes
pEtR	paître
pOR	ports
pORS	porches
pORidZ	porridge
pORno	pornos
pORs(lEn	porcelaines
pORt	portes
pORtER	portèrent
pORtRE	portraits
pORtaj	portails
pORto	portos
pOS	poches
pOlise	policer
pOlka	polkas
pOm	pommes
pOp	popes
pOst	postes
pOsteRite	postérités
pOstyR	postures
pOstyle	postulé
pOt	potes
pR)	prompts
pR2mje	premiers
pR5s	princes
pR5sip	principes
pR5t@	printemps
pR9v	preuves
pR@dR	prendre
pRE	prêts
pREsbitER	presbytère
pREsk	presque
pREskRiR	prescrire
pREstiZ	prestiges
pREsto	presto
pREtR	prêtres
pREv(niR	prévenir
pROS	proches
pROf	profs
pROmnad	promenades
pROmne	promener
pROpR	propres
pROpR(te	propreté
pROskRiR	proscrire
pROspER	prospères
pROspEktys	prospectus
pROstat	prostate
pROstit8e	prostitués
pRatik	pratiques
pRe	prés
pRe@s9R	préhenseur
pReZydis	préjudices
pRediR	prédirent
pRefE	préfets
pRefeRe	préférés
pRekOs	précoces
pRekonize	préconisés
pRel(ve	prélevés
pRepaRatif	préparatifs
pRepaRe	préparés
pResEpt	préceptes
pRese	pressés
pResed@	précédents
pResede	précédés
pResi	précis
pResiG	pressings
pResipis	précipices
pResipite	précipités
pResize	précisés
pRet@dR	prétendre
pRet@dy	prétendus
pRevalwaR	prévaloir
pRevwaR	prévoir
pRez@	présents
pRez@t	présentes
pRezERve	préservés
pRezaZ	présages
pRezid@	présidents
pRezide	présidés
pRezyme	présumés
pRi	prît
pRijER	prières
pRijoRite	priorités
pRim	prîmes
pRimER	primaires
pRimORdjal	primordiales
pRimat	primates
pRimo	primo
pRive	privés
pRivilEZ	privilèges
pRiz)	prisons
pRize	prisés
pRizonje	prisonniers
pRo	pros
pRoS5	prochains
pRoZ(te	projetés
pRoZE	projets
pRoZEktil	projectiles
pRoZenityR	progénitures
pRoblEm	problèmes
pRod8iR	produire
pRodiZ	prodiges
pRodig	prodigues
pRof)	profonds
pRofEt	prophètes
pRofan	profanes
pRofesi	prophéties
pRofi	profits
pRofil	profils
pRogRE	progrès
pRogRam	programmes
pRokRee	procréé
pRoklame	proclamés
pRokyRe	procurés
pRol)Ze	prolongés
pRoletER	prolétaires
pRomEs	promesses
pRomEtR	promettre
pRomi	promît
pRomo	promos
pRomot9R	promoteurs
pRomuvwaR	promouvoir
pRon)se	prononcés
pRonOstik	pronostique
pRone	prônés
pRopRijetER	propriétaires
pRopRijete	propriétés
pRopRijo	proprios
pRopaZe	propagés
pRopag@d	propagandes
pRopis	propices
pRopo	propos
pRopoze	proposés
pRopylse	propulsés
pRosE	procès
pRosede	procédés
pRosedyR	procédures
pRostERne	prosternés
pRotEste	protestés
pRotEz	prothèses
pRoteZe	protégés
pRotein	protéines
pRotokOl	protocoles
pRov(n@s	provenances
pRov(niR	provenir
pRov5s	provinces
pRovERb	proverbes
pRovid@s	providence
pRoviz9R	proviseurs
pRovizwaR	provisoires
pRovoke	provoqués
pRu	proues
pRuve	prouvés
pRwa	proies
pRyRit	prurit
pRyd@	prudents
pRyn	prunes
pRynEl	prunelles
pRyno	pruneaux
pa	pât
paR	parts
paR5	parrains
paR@	parents
paR@tEz	parenthèses
paREj	pareils
paREtR	paraître
paROl	paroles
paRS(m5	parchemins
paRZyR	parjures
paRa	paras
paRaSyt	parachutes
paRabOl	paraboles
paRad	parades
paRadOks	paradoxes
paRadi	paradis
paRagRaf	paragraphes
paRalEl	parallèles
paRalize	paralysés
paRamEtR	paramètres
paRanoja	paranoïa
paRapl8i	parapluies
paRav@	paravents
paRazit	parasites
paRd(sy	pardessus
paRd)	pardons
paRdone	pardonnés
paRf1	parfums
paRfE	parfaits
paRfwa	parfois
paRfyme	parfumés
paRi	paris
paRja	parias
paRk	parquent
paRkE	parquets
paRkiG	parkings
paRkuR	parcourt
paRle	parlés
paRlwaR	parloirs
paRmi	parmi
paRodi	parodies
paRsEl	parcelles
paRsjEl	partiels
paRt(nER	partenaires
paRtaZ	partages
paRtiR	partirent
paRtikyl	particules
paRtisipe	participés
paRtiz@	partisans
paRtu	partout
paRwa	parois
paRyR	parures
paSa	pachas
paZ	pages
padi	paddy
paela	paellas
paf	paf
pagaj	pagaïe
paj	pailles
paj5	païens
pajEt	paillettes
pajas	paillasses
pak	pâques
pak(bo	paquebots
pakE	paquets
pakotij	pacotilles
pakt	pactes
paktOl	pactoles
pal	pâles
palE	palets
palas	palaces
palm	palmes
palpe	palpés
palpite	palpité
paluRd	palourdes
pan	paonne
panaS	panaches
panike	paniqués
pano	panos
panoRama	panoramas
panopli	panoplies
pap	papes
pap(Ras	paperasses
papE	papet
papa	papas
papaRadzi	paparazzis
papi	papys
papiRys	papyrus
papote	papoté
pas(REl	passerelles
pasaZe	passagers
pase	passés
pasibl	passibles
pasif	passifs
pasj@	patients
pasjonEl	passionnels
pasjone	passionnés
paspOR	passeports
past9R	pasteurs
pastEk	pastèques
pastij	pastilles
pastis	pastis
paswaR	passoires
pat	pâtes
pat(l5	patelins
pat5	patins
patR)	patrons
patRi	patries
patRimwan	patrimoines
patRuj	patrouilles
patS	patchs
patat	patates
patetik	pathétiques
patiR	pâtirent
patinwaR	patinoires
patis(Ri	pâtisseries
patisje	pâtissiers
patjo	patios
patoZe	pataugé
patyR	pâtures
pavane	pavané
pave	pavés
pavij)	pavillons
peNe	peignés
peRiR	périrent
peRifeRi	périphéries
peRil	périls
peRime	périmés
peRipl	périples
peRiskOp	périscopes
peRjOd	périodes
peRyvj5	péruviens
peSe	pêchés
peaZ	péages
pedal	pédales
pei	pays
peiz@	paysans
peizaZ	paysages
pekinwa	pékinois
pelikyl	pellicules
pen)bR	pénombres
penalti	penalty
pene	pennées
penetRe	pénétrés
peni	penny
peniS	péniches
penibl	pénibles
penisilin	pénicilline
penit@s	pénitences
penit@sjER	pénitentiaires
pep5	pépins
pepER	pépères
pepe	pépés
pepit	pépites
petR5	pétrins
petROl	pétroles
petRiR	pétrirent
petRifje	pétrifiés
petaR	pétards
petal	pétales
petas	pétasses
pezeta	pesetas
pezibl	paisibles
pezo	peso
piN)	pignons
piR	pires
piRamid	pyramides
piRana	piranhas
piRat	pirates
piRsiG	piercings
piRwEt	pirouettes
piSE	pichets
piZ	piges
piZ)	pigeons
piZama	pyjamas
pidza	pizzas
pif	pif
pijaR	pillards
pike	piqués
pikole	picolé
pikyR	piqûres
pil	piles
pilOt	pilotes
pilyl	pilules
pin	pines
pink	pink
pip	pipes
pipi	pipis
pipo	pipo
pis@li	pissenlits
pise	pissée
pisin	piscines
pist)	pistons
pistolE	pistolets
pisu	pissou
pit)	pythons
pitR	pitres
pitbul	pitbulls
pitje	pitiés
pitoREsk	pittoresques
pivote	pivoté
pj)	pions
pj)se	pioncé
pj2	pieux
pj9vR	pieuvres
pjER	pierres
pjEZ	pièges
pjEs	pièces
pjEtR	piètres
pjOS	pioches
pjadza	piazza
pjaf	piafs
pjano	pianos
pjastR	piastres
pje	pieds
pjeZe	piégés
pjetine	piétinés
pjoSe	piochées
pjol	piaules
pjonje	pionniers
pl)	plombs
pl)Z	plonges
pl)Z)	plongeons
pl)b	plombes
pl2Re	pleurer
pl2vwaR	pleuvoir
pl5	pleins
pl5dR	plaindre
pl5t	plinthes
pl8i	pluies
pl9R	pleurs
pl@	plants
pl@S	planches
pl@k	planques
pl@t	plantes
plE	plet
plER	plaire
plEn	pleines
plEz@	plaisanté
pla	plats
plaZ	plages
plaf)	plafonds
plak	plaques
plakaR	placards
planEt	planètes
plane	plané
planiG	plannings
plase	placés
plasma	plasma
plastik	plastiques
platR	plâtres
platin	platines
plato	plateaux
plede	plaidée
pleziR	plaisirs
pli	plis
plozibl	plausibles
ply	plût
plym	plumes
plyto	plutôt
pn2	pneus
po	pots
poEm	poèmes
poEt	poètes
poN)	pognon
poRte	porter
podjOm	podiums
poezi	poésies
pokER	pokers
pol	pôles
pol8e	pollués
polEn	pollens
poliR	polir
polis)	polissons
politEs	politesses
politik	politiques
poljo	polios
polo	polos
polonE	polonais
pom	paumes
pomad	pommades
ponE	poneys
popjER	paupières
popylas	populace
posede	possédés
posibl	possibles
pot5	potins
pot@s	potences
pot@sjEl	potentiels
potaZ	potages
potiR)	potirons
povR	pauvres
poze	posés
pozitif	positifs
ps2do	pseudos
psi	psys
psiko	psycho
psom	psaumes
pu	poux
puR	pour
puRSase	pourchassés
puRbwaR	pourboires
puRityR	pourritures
puRkwa	pourquoi
puRpR	pourpres
puRs8ivR	poursuivre
puRs@taZ	pourcentages
puRvwaR	pourvoir
pubEl	poubelles
pudR	poudres
pudiG	puddings
pul	poules
pul5	poulains
puliS	pouliches
pulp	poulpes
pum)	poumons
pup	poupe
pus5	poussins
puse	poussés
pusjER	poussières
putR	poutres
putS	putsch
puvwaR	pouvoirs
pw5	points
pw5dR	poindre
pw5t	pointes
pw5tyR	pointures
pwa	pouah
pwaN	poignes
pwaNaR	poignards
pwaR	poires
pwaRo	poireaux
pwal	poêles
pwaly	poilus
pwas)	poissons
pwatRin	poitrines
pwavR	poivres
pwavR)	poivrons
pwavRo	poivrots
pwaz)	poisons
py	pût
pyR	purs
pyRZ	purges
pybERte	puberté
pyblije	publiés
pyblik	publiques
pyblisite	publicités
pyd9R	pudeurs
pyl	pulls
pylveRize	pulvérisés
pyma	pumas
pynEz	punaises
pyniR	punir
pypij	pupilles
pyso	puceaux
pyt	pûtes
pyt5	putains
pytRid	putrides
pytwa	putois
s(R5	serins
s(R5g	seringues
s(Riz	cerises
s(g)	seconds
s(g)d	secondes
s(kRE	secrets
s(kRetER	secrétaires
s(kuRiR	secourir
s(kus	secousses
s(kwe	secoués
s(l)	selon
s(mEl	semelles
s(mEn	semaines
s(mEstR	semestres
s(me	semés
s)	sont
s)Z	songes
s)bR	sombres
s)d	sondes
s5	seins
s5Z	singes
s5bOl	symboles
s5bjOt	symbiotes
s5dRom	syndromes
s5dika	syndicats
s5foni	symphonies
s5gle	cinglés
s5gylje	singuliers
s5kRonize	synchronisés
s5pa	sympas
s5pl	simples
s5ptom	symptômes
s5sER	sincères
s5tEz	synthèses
s5tije	scintillé
s5tte	saintetés
s5tyR	ceintures
s89R	sueurs
s8av	suaves
s8e	suées
s8edwa	suédois
s8is	suisses
s8isid	suicides
s8it	suites
s8ivR	suivre
s8ivi	suivît
s9R	soeurs
s9Rf	surfes
s9j	seuils
s9l	seuls
s@	sent
s@ba	samba
s@ble	semblé
s@dR	sandres
s@gl	sangles
s@glote	sanglotés
s@kt8ER	sanctuaires
s@s8El	sensuels
s@sas	sensass
s@se	sensés
s@sibl	sensibles
s@sy	sangsues
s@syR	censures
s@t@s	sentences
s@tR	centres
s@tRal	centrales
s@tiR	sentirent
s@tim	sentîmes
s@tinEl	sentinelles
s@tje	sentiez
s@tyRj)	centurions
sEN9R	seigneurs
sER	sert
sERZ	serges
sERZ@	sergents
sERb	serbes
sERk9j	cercueils
sERkl	cercles
sERm)	sermons
sERm@	serments
sERmone	sermonnée
sERn	cernes
sERp@	serpents
sERpijER	serpillières
sERt	certes
sERt5	certains
sERtaw	sertão
sERvEl	cervelles
sERviR	servirent
sERvil	serviles
sERvjEt	serviettes
sERvo	cerveaux
sEk	secs
sEkt	sectes
sEl	sels
sEn	senne
sEpt@bR	septembre
sEptR	sceptres
sEptik	septique
sEs	cesses
sEt	sets
sEv	sèves
sEz)	saisons
sOR	sorts
sORdid	sordides
sORnEt	sornettes
sORsje	sorciers
sORt	sortes
sORtiR	sortirent
sObR	sobres
sOfi	sophie
sOl	sols
sOld	soldes
sOlda	soldât
sOm	sommes
sa	çà
saRdin	sardines
saRkasm	sarcasmes
saRkofaZ	sarcophages
saZ	sages
sabR	sabres
saba	sabbats
sabl	sables
sabo	sabots
sadik	sadiques
safaRi	safaris
saib	sahibs
sak	saquent
sakRe	sacrés
sakRifis	sacrifices
sakRilEZ	sacrilèges
sakaZe	saccagés
sakade	saccadés
saksofOn	saxophones
sal	sals
sal(te	saletés
sal)	salons
sal8e	salués
salER	salaires
salad	salades
salami	salamis
saliR	salir
saliv	salives
salsa	salsa
salun	saloons
salv	salves
saly	saluts
sam(di	samedis
samuRaj	samurai
sap5	sapins
sape	sapés
sat5	satins
satane	satanés
satanik	sataniques
satelit	satellites
satisfE	satisfaits
satyRe	saturés
sav)	savons
sav9R	saveurs
savuRe	savourés
savwaR	savoirs
sbiR	sbires
se@s	séances
seNOR	señor
seNe	saignés
seROm	sérums
seRe	serrés
seReal	céréales
seRemoni	cérémonies
seRenad	sérénades
seRi	séries
seRyR	serrures
seS(REs	sécheresses
seSe	séchés
seZuR	séjours
seZuRne	séjourné
sed8iR	séduire
sedatif	sédatifs
sede	cédés
sek@s	séquences
sekEl	séquelles
sekEstRe	séquestrés
seks8El	sexuels
seksi	sexy
sekt9R	secteurs
seky	sécu
sekyRize	sécurisés
selEbR	célèbres
selEst	célestes
sele	seller
seleRa	scélérats
selebRe	célébrés
seliba	célibat
selje	sellier
selyl	cellules
seminER	séminaires
sena	sénat
senaRjo	scénarios
senat9R	sénateurs
senil	séniles
sepaRe	séparés
sepyltyR	sépultures
sese	cessé
sesj)	sessions
sevER	sévères
seviR	sévir
sezaRjEn	césariennes
sezam	sésame
seziR	saisirent
sf5ks	sphinx
sfER	sphères
siN	signes
siNOR	signor
siNal	signales
siNatyR	signatures
siNifje	signifiées
siR	sires
siREn	sirènes
siRk	cirques
siRk)siR	circoncire
siRk)st@s	circonstances
siRk8i	circuits
siRkyle	circulé
siRo	syro
siRoko	sirocco
sibl	cibles
sidR	cidre
sida	sidas
sideRe	sidérés
sifilis	syphilis
sifle	sifflés
sigON	cigognes
sigaR	cigares
sigal	cigales
sikatRis	cicatrices
sikl	sicle
siklOp	cyclopes
siklo	cyclo
siklon	cyclones
sil	sils
sil5dR	cylindres
sil@s	silences
silab	syllabes
silikOn	silicone
silo	silos
silwEt	silhouettes
sim	cymes
sim(tjER	cimetières
simagRe	simagrées
simetRi	symétries
similER	similaires
simyle	simulés
sin)	sinon
sinema	cinémas
sing9l	single
sinik	cyniques
sinistR	sinistres
sinys	sinus
sisilj5	siciliens
sistEm	systèmes
sit	sites
sit8e	situés
sitERn	citernes
sitR)	citrons
sitRuj	citrouilles
sitad5	citadins
sito	sitôt
sitwaj5	citoyens
sivil	civils
sivjER	civières
sizaj	cisailles
sizo	ciseaux
sj9R	sieurs
sjERZ	cierges
sjERa	sierras
sjEZ	sièges
sjEkl	siècles
sjEl	ciels
sjEst	siestes
sjamwa	siamois
sjanyR	cyanure
sje	siéent
sjeZe	siégé
sk(lEt	squelettes
sk@dal	scandales
skEtS	sketchs
skOR	scores
skORpj)	scorpions
skOtS	scotchs
skROb	scrub
skRabl	scrabble
skRib	scribes
skRipt	scripts
skRypyl	scrupules
skRyte	scrutés
skaRabe	scarabées
skalp	scalps
skalpEl	scalpels
skanER	scanners
ski	skis
skup	scoops
skut	scouts
skut9R	scooters
skwaR	squares
skwat	squatte
skwat9R	squatteurs
skylte	sculptés
skyltyR	sculptures
slip	slips
slog@	slogans
smOkiG	smokings
snOb	snobs
snife	sniffées
so	sots
soRe	saurez
soZa	soja
soda	sodas
sodomi	sodomie
sof	saufs
sofa	sofas
sofistike	sophistiqués
sol	saules
solEj	soleils
solanEl	solennels
solid	solides
solidER	solidaires
solisite	sollicités
solitER	solitaires
solo	solos
som)	sommons
somE	sommets
somEj	sommeils
some	sommés
sonE	sonnets
sonOR	sonores
sona	sonnât
sonaR	sonars
sonat	sonates
sone	sonnés
sono	sonos
sopRano	sopranos
sosis	saucisses
sosis)	saucissons
sosjete	sociétés
sot	sautes
sot(REl	sauterelles
sotiz	sottises
sov(gaRd	sauvegardes
sovaZ	sauvages
sove	sauvés
sovjEt	soviets
sozi	sosies
sp)sOR	sponsors
sp)soRize	sponsorisés
sp)tane	spontanés
spERm	spermes
spEktR	spectres
spEktakl	spectacles
spOR	sports
spOt	spots
spREj	sprays
spa	spas
spaRadRa	sparadraps
spageti	spaghettis
spajd9R	spider
spasm	spasmes
spekyle	spéculé
spesimEn	spécimens
spesjal	spéciales
spiRal	spirales
spiRit8El	spirituels
spid	speedes
spik9R	speakers
spitS	speech
spl@did	splendides
st@d	stands
st@daR	standards
st@diG	standing
stEk	steaks
stElER	stellaires
stEp	steppes
stOR	stores
stOk	stocks
stOp	stops
stREs	stressent
stRatEZ	stratèges
stRiG	strings
stRikt	stricts
stRip	strip
stRyktyR	structures
staR	stars
staRt9R	starter
staZ	stages
stabl	stables
stad	stades
staf	staffs
statistik	statistiques
staty	statuts
staz	stase
steReo	stéréos
steRil	stériles
steRoid	stéroïdes
stil	styles
stilo	stylos
stimyle	stimulés
stipyle	stipulés
stoke	stockés
ston	stones
stope	stoppés
stydjo	studios
styp9R	stupeur
stypid	stupides
su	soûls
suR	sourds
suRiR	sourires
suRnwa	sournois
suRsi	sourcils
suS	souches
suSi	sushi
subREt	soubrettes
sud5	soudains
sude	soudés
sudwaje	soudoyés
sudyR	soudures
sufR	soufre
sufR@s	souffrances
sufl	souffles
sukup	soucoupes
sul	soûlent
sul(ve	soulevés
sulaR	soûlards
sulaZe	soulagés
suliNe	soulignés
sumEtR	soumettre
sumi	soumît
sup	soupes
supiR	soupirs
supl	souples
sups)	soupçons
susi	soucis
susje	souciés
sustRER	soustraire
sut	soutes
sut(niR	soutenir
sutER5	souterrains
sutan	soutanes
sutiRe	soutirées
sutif	soutifs
sutj5	soutient
suv(R5	souverains
suv(niR	souvenirs
suv@	souvent
sw5	soins
swE	souhaits
swa	soit
swaNe	soignés
swaR	soirs
swaf	soifs
swete	souhaités
sy	sût
syR	sûrs
syRZiR	surgirent
syRfas	surfaces
syRkRwa	surcroîts
syRm(ne	surmenés
syRm)te	surmontés
syRnome	surnommés
syRsi	sursis
syRtu	surtouts
syRv(niR	survenir
syRveje	surveillés
syRvivR	survivre
syRvole	survolées
syZE	sujets
sybiR	subirent
syblim	sublimes
sybmERZe	submergés
sybv(niR	subvenir
sybziste	subsisté
syd	sud
syfiR	suffirent
syfoke	suffoqués
sygZeRe	suggérés
syk)be	succombé
sykR	sucres
syksE	succès
syksede	succédées
sykyRsal	succursales
sykyl@	succulents
sylt@	sultans
sypER	supers
sypERb	superbes
sypERfly	superflus
sypERvize	supervisés
sypOR	supports
sypREm	suprêmes
sypRime	supprimés
sypeRj9R	supérieurs
syplije	suppliés
syplis	supplices
sypoRt9R	supporter
sypoRte	supporter
sypoze	supposés
sypst@s	substances
sypstit8e	substitués
sypstity	substituts
syptil	subtils
sys)	suçons
sysEptibl	susceptibles
syse	sucés
sysite	suscités
sysp@	suspens
sytyR	sutures
t(naj	tenailles
t(nas	tenaces
t(niR	tenir
t(ny	tenus
t)	tons
t)b	tombes
t)bo	tombeaux
t)bola	tombolas
t)dR	tondre
t)g	tongs
t5	tînt
t5bR	timbres
t5dR	teindre
t5tyR	teintures
t8e	tués
t8ijo	tuyaux
t8il	tuiles
t@	tends
t@Zibl	tangibles
t@buR	tambours
t@d)	tendons
t@d@s	tendances
t@dR	tendres
t@dy	tendus
t@go	tangos
t@k	tanks
t@p	tempes
t@p)	tampons
t@pEt	tempêtes
t@peRatyR	températures
t@pl	temples
t@pone	tamponnés
t@sj)	tensions
t@t	tentes
t@takyl	tentacules
t@tativ	tentatives
t@tin	tantines
t@tinE	tantinet
t@to	tantôt
t@tuz	tantouzes
tEN	teignes
tER	terres
tER5	terrains
tER9R	terreurs
tERm	thermes
tERmine	terminés
tERn	ternes
tERsjo	tertio
tEknik	techniques
tEkst	textes
tEl	tél
tEm	thèmes
tEmpo	tempos
tEst	tests
tEstikyl	testicules
tEstosteROn	testostérones
tEz	thèses
tOR	torts
tORS	torches
tORS)	torchons
tORdR	tordre
tORdy	tordus
tORnad	tornades
tORpij	torpilles
tORtija	tortillas
tORtije	tortillés
tORty	tortus
tORtyR	tortures
tOk	toques
tOksik	toxiques
tOksin	toxines
tOm	tommes
tOn	tonnes
tR)	troncs
tR)S	tronches
tR)bOn	trombones
tR)p	trompes
tR5bale	trimbalés
tR5ke	trinqué
tR8i	truies
tR8it	truites
tR9j	treuils
tR9st	trusts
tR@S	tranches
tR@bl	trembles
tR@kil	tranquilles
tR@p	trempes
tR@polin	trampoline
tR@s	transes
tR@sfER	transfèrent
tR@spOR	transports
tR@spaR@	transparents
tR@spiRe	transpiré
tR@t	trente
tR@zistOR	transistors
tR@zit	transits
tRE	très
tRER	traire
tREfl	trèfles
tREj	treilles
tREn	traînes
tREno	traîneaux
tREt	traites
tREtR	traîtres
tREv	trêves
tROk	troque
tROl	trolls
tRaZE	trajets
tRaZedi	tragédies
tRad8iR	traduire
tRafik	trafiques
tRaiR	trahirent
tRaiz)	trahisons
tRak	traques
tRak(naR	traquenards
tRaka	traqua
tRam	trams
tRap	trappes
tRapEz	trapèzes
tRas	traces
tRav(lo	travelos
tRavER	travers
tRavEsti	travestit
tRavaj	travailles
tRebySe	trébuché
tRene	traînés
tRepje	trépieds
tResajiR	tressaillirent
tRese	tressés
tRetRiz	traîtrises
tRete	traités
tRezOR	trésors
tRi	tris
tRiS	triches
tRibOR	tribord
tRiby	tributs
tRibyn	tribunes
tRibynal	tribunal
tRij)f	triomphes
tRijaZ	triage
tRijad	triades
tRiko	tricots
tRime	trimé
tRip	trips
tRipl	triples
tRipo	tripots
tRistEs	tristesses
tRo	trots
tRofe	trophées
tRoke	troqués
tRoma	traumas
tRon	trônes
tRotwaR	trottoirs
tRubl	troubles
tRudyk	trouduc
tRue	troués
tRuj	trouilles
tRup	troupes
tRus	trousses
tRuso	trousseaux
tRuvaj	trouvailles
tRuve	trouvés
tRyf	truffes
tRyke	truqués
tRyside	trucidés
tSalEndZ	challenge
ta	tas
taR	tares
taRde	tardée
taRiR	tarirent
taRif	tarifs
taRo	tarots
taRt	tartes
taS	tâches
taba	tabacs
tabase	tabassés
tablo	tableaux
tabu	tabous
tabuRE	tabourets
taf	tafs
taj	thaïs
tak	tacs
takine	taquinée
tako	tacots
takse	taxés
taksi	taxis
takt	tact
tal)	talons
tal@	talents
talisman	talismans
talk	talc
tane	tannés
tanjER	tanières
tap	tapes
tap5	tapins
tapi	tapit
tapine	tapinée
tapote	tapoté
tase	tassés
tasityRn	taciturnes
tata	tâta
tatwe	tatoués
tavERn	tavernes
te	tés
teRapi	thérapies
teatR	théâtres
tejER	théières
tekila	tequila
telEks	télexes
telEskOp	télescopes
teleSaRZe	téléchargés
telefOn	téléphones
televizj)	télévisions
temeRER	téméraires
tenEbR	ténèbres
tenOR	ténors
tenis	tennis
teoRi	théories
teoloZi	théologies
tet)	tétons
tety	têtus
tiR	tirs
tiR(liR	tirelires
tiR@	tyrans
tiRad	tirades
tiRwaR	tiroirs
tiZ	tiges
tibja	tibias
tif	tifs
tigR	tigres
tij9l	tilleuls
tik	tiques
tikE	tiquait
tilt	tilts
tim	teams
timid	timides
tip	types
tise	tissés
tisy	tissus
tit@	titans
titR	titres
titan	titane
titi	titis
titybe	titubé
tizan	tisanes
tjER	tiers
tjERse	tiercés
tjEd	tièdes
to	tôt
toRaks	thorax
toReRo	toreros
toRid	torrides
toRo	taureaux
todi	taudis
tofy	tofu
tokaR	toquards
toke	toqués
tol	tôles
tolaR	tolar
toleRe	tolérés
toma	toma
tomat	tomates
tonER	tonnerres
tone	tonné
tono	tonneaux
top	taupes
tost	toasts
totEm	totems
total	totales
tsaR	tzars
tu	toux
tuR	tours
tuRbij)	tourbillons
tuRm@	tourments
tuRm@t	tourmentes
tuRn	tournes
tuRnwa	tournois
tuRnyR	tournures
tuRt	tourtes
tuRt2Ro	tourtereau
tuS	touches
tuZuR	toujours
tubib	toubibs
tuf	touffes
tupE	toupets
tupi	toupies
tuse	toussé
tutu	toutous
twa	toits
twal	toiles
twalEt	toilettes
ty	tût
tyRbin	turbines
tyRi	tueries
tyRk	turques
tyb	tubes
tybERkyloz	tuberculose
tyba	tubas
tylip	tulipes
tym9R	tumeurs
tymylt	tumultes
tyn	tunes
tynEl	tunnels
tyt9R	tuteurs
uRa	hourras
uRag@	ouragans
uRs	ourses
uRs)	oursons
ubli	oublis
ut	août
utR	outres
utRaZe	outragés
uti	outils
uvER	ouverts
uvRije	ouvriers
v(dEt	vedettes
v(luR	velours
v(ly	velus
v(n5	venins
v(niR	venir
v(ny	venus
v2	voeux
v5	vînt
v5kR	vaincre
v5ky	vaincus
v5tEn	vingtaines
v9f	veufs
v@	vents
v@Ze	vengés
v@d@Z	vendanges
v@dEta	vendettas
v@dR	vendre
v@dR(di	vendredis
v@dal	vandales
v@piR	vampires
v@t	ventes
vER	verts
vERZe	vergés
vERb	verbes
vERdikt	verdicts
vERdyR	verdures
vERmEj	vermeils
vERmin	vermines
vERmut	vermouths
vERniR	vernir
vERse	versés
vERsj)	versions
vERtEbR	vertèbres
vERtiZ	vertiges
vERty	vertus
vEj	veilles
vEkse	vexés
vEn	veines
vEnaR	veinards
vEsEl	vaisselles
vEspa	vespas
vEst	vestes
vEst)	vestons
vEstiZ	vestiges
vEstjER	vestiaires
vOdka	vodkas
vOl	vols
vOltiZe	voltigé
vOt	votes
vRE	vrais
vRak	vrac
vaRisEl	varicelle
vaRjOl	variole
vaRje	variés
vaS	vaches
vag	vagues
vagab)	vagabonds
vaj@s	vaillance
vak@s	vacances
vakaRm	vacarmes
vaksine	vaccinés
val)	valons
valE	valets
vale	vallées
valid	valides
valiz	valises
vals	valses
valv	valves
valwaR	valoir
van	vans
vanij	vanille
vap	vaps
vap9R	vapeurs
vasal	vassale
vasije	vacillé
vast	vastes
veR@da	vérandas
veRifje	vérifiés
veRu	verrous
veRy	verrues
veikyl	véhicules
veje	veillés
veky	vécût
veneRe	vénérés
vesi	vessies
veteR@	vétérans
veteRinER	vétérinaires
vetiR	vêtir
veto	veto
vety	vêtus
vezikyl	vésicules
vi	vît
viN	vignes
viRe	virés
viRgyl	virgules
viRil	virils
viRt8El	virtuels
viRys	virus
viZil	vigiles
vibRe	vibrées
vid	vides
vid@Z	vidanges
video	vidéos
vif	vifs
vig9R	vigueurs
viktim	victimes
viktwaR	victoires
vil	vils
vilaZ	villages
villa	villas
vinEgR	vinaigres
vipER	vipères
vise	vissés
vit	vite
vitR	vitres
vitamin	vitamines
vivR	vivres
viz)	visons
viz8El	visuels
viza	visas
vizaZ	visages
vize	visés
vizit	visites
vizj)	visions
vj@d	viandes
vjERZ	vierges
vjOl	viols
vjol)	violons
vjol@	violents
vjolE	violets
vjole	violés
vo	vos
voRj5	vauriens
vodu	vodous
voge	vogué
vokabylER	vocabulaires
vokal	vocales
vol)te	volontés
vol)tje	volontiers
volE	volley
volaZ	volages
volaj	volailles
vole	volés
volym	volumes
volypte	voluptés
vomiR	vomirent
votR	vôtres
votuR	vautours
vulwaR	vouloirs
vuly	voulût
vut	voûtes
vwa	voua
vwaR	voire
vwajaZ	voyages
vwaju	voyous
vwal	voiles
vwala	voilà
vwasi	voici
vwatyR	voitures
vwaz5	voisins
vwe	voués
vy	vus
vylgER	vulgaires
wE	ouais
wEb	web
wEst	ouest
wazo	oiseaux
wiR	ouïr
wiski	whiskys
yRZ@	urgents
yRanjOm	uranium
yRb5	urbains
yRin	urines
yRle	hurlés
yRn	urnes
yRtikER	urticaire
yblo	hublots
ylsER	ulcères
yltRa	ultras
yltim	ultimes
yltimatOm	ultimatums
ym5	humains
ym9R	humeurs
ymid	humides
ymilje	humiliés
ymuR	humour
yn	unes
ynanim	unanimes
yniR	unirent
ynivER	univers
ynivERsite	universités
ys	us
yst@sil	ustensiles
yt	ut
yteRys	utérus
ytil	utiles
ytopi	utopies
yzaZ	usages
yze	usés
yzin	usines
yzyR	usures
yzyRpe	usurpés
z)bi	zombis
z5g	zincs
zEbR	zèbres
zEl	zèles
zEn	zens
zOb	zobs
zape	zappé
zeRo	zéros
zele	zélés
zib(lin	zibelines
ziguje	zigouillés
zizi	zizis
zloti	zlotys
zon	zones
zum	zooms